ocd-division/country:us/state:nc/county:sampson/precinct:absentee	ocd-division/country:us/state:nc/county:sampson/precinct:absentee
ocd-division/country:us/state:nc/county:sampson/precinct:one_stop_1	ocd-division/country:us/state:nc/county:sampson/precinct:one_stop
ocd-division/country:us/state:nc/county:sampson/precinct:one_stop_2	ocd-division/country:us/state:nc/county:sampson/precinct:one_stop
ocd-division/country:us/state:nc/county:sampson/precinct:one_stop_3	ocd-division/country:us/state:nc/county:sampson/precinct:one_stop
ocd-division/country:us/state:nc/county:sampson/precinct:one_stop_4	ocd-division/country:us/state:nc/county:sampson/precinct:one_stop
ocd-division/country:us/state:nc/county:sampson/precinct:one_stop_5	ocd-division/country:us/state:nc/county:sampson/precinct:one_stop
ocd-division/country:us/state:nc/county:tyrrell/precinct:1	ocd-division/country:us/state:nc/county:tyrrell/precinct:01
ocd-division/country:us/state:nc/county:tyrrell/precinct:2	ocd-division/country:us/state:nc/county:tyrrell/precinct:02
ocd-division/country:us/state:nc/county:tyrrell/precinct:3	ocd-division/country:us/state:nc/county:tyrrell/precinct:03
ocd-division/country:us/state:nc/county:tyrrell/precinct:absentee	ocd-division/country:us/state:nc/county:tyrrell/precinct:absentee
ocd-division/country:us/state:nc/county:tyrrell/precinct:one_stop	ocd-division/country:us/state:nc/county:tyrrell/precinct:one_stop
ocd-division/country:us/state:nc/county:hertford/precinct:mail_absentee	ocd-division/country:us/state:nc/county:hertford/precinct:absentee
ocd-division/country:us/state:nc/county:hertford/precinct:os_ahoskie	ocd-division/country:us/state:nc/county:hertford/precinct:one_stop
ocd-division/country:us/state:nc/county:hertford/precinct:os_boe	ocd-division/country:us/state:nc/county:hertford/precinct:one_stop
ocd-division/country:us/state:nc/county:hertford/precinct:os_mboro	ocd-division/country:us/state:nc/county:hertford/precinct:one_stop
ocd-division/country:us/state:nc/county:moore/precinct:absentee	ocd-division/country:us/state:nc/county:moore/precinct:absentee
ocd-division/country:us/state:nc/county:moore/precinct:ekwd	ocd-division/country:us/state:nc/county:moore/precinct:kwd
ocd-division/country:us/state:nc/county:moore/precinct:eur-wp	ocd-division/country:us/state:nc/county:moore/precinct:eur
ocd-division/country:us/state:nc/county:moore/precinct:os-ag_paper	ocd-division/country:us/state:nc/county:moore/precinct:one_stop
ocd-division/country:us/state:nc/county:moore/precinct:os-dc_paper	ocd-division/country:us/state:nc/county:moore/precinct:one_stop
ocd-division/country:us/state:nc/county:moore/precinct:os-pfd_paper	ocd-division/country:us/state:nc/county:moore/precinct:one_stop
ocd-division/country:us/state:nc/county:moore/precinct:os-vrs_paper	ocd-division/country:us/state:nc/county:moore/precinct:one_stop
ocd-division/country:us/state:nc/county:moore/precinct:os-weg_paper	ocd-division/country:us/state:nc/county:moore/precinct:one_stop
ocd-division/country:us/state:nc/county:moore/precinct:pha1	ocd-division/country:us/state:nc/county:moore/precinct:pha
ocd-division/country:us/state:nc/county:moore/precinct:pha2	ocd-division/country:us/state:nc/county:moore/precinct:pha
ocd-division/country:us/state:nc/county:moore/precinct:wkwd	ocd-division/country:us/state:nc/county:moore/precinct:wnd
ocd-division/country:us/state:nc/county:beaufort/precinct:absentee	ocd-division/country:us/state:nc/county:beaufort/precinct:absentee
ocd-division/country:us/state:nc/county:beaufort/precinct:os_aur	ocd-division/country:us/state:nc/county:beaufort/precinct:one_stop
ocd-division/country:us/state:nc/county:beaufort/precinct:os_bel	ocd-division/country:us/state:nc/county:beaufort/precinct:one_stop
ocd-division/country:us/state:nc/county:beaufort/precinct:os_boe	ocd-division/country:us/state:nc/county:beaufort/precinct:one_stop
ocd-division/country:us/state:nc/county:beaufort/precinct:os_cho	ocd-division/country:us/state:nc/county:beaufort/precinct:one_stop
ocd-division/country:us/state:nc/county:davie/precinct:1	ocd-division/country:us/state:nc/county:davie/precinct:01
ocd-division/country:us/state:nc/county:davie/precinct:2	ocd-division/country:us/state:nc/county:davie/precinct:02
ocd-division/country:us/state:nc/county:davie/precinct:3	ocd-division/country:us/state:nc/county:davie/precinct:03
ocd-division/country:us/state:nc/county:davie/precinct:4	ocd-division/country:us/state:nc/county:davie/precinct:04
ocd-division/country:us/state:nc/county:davie/precinct:5	ocd-division/country:us/state:nc/county:davie/precinct:05
ocd-division/country:us/state:nc/county:davie/precinct:6	ocd-division/country:us/state:nc/county:davie/precinct:06
ocd-division/country:us/state:nc/county:davie/precinct:7	ocd-division/country:us/state:nc/county:davie/precinct:07
ocd-division/country:us/state:nc/county:davie/precinct:8	ocd-division/country:us/state:nc/county:davie/precinct:08
ocd-division/country:us/state:nc/county:davie/precinct:9	ocd-division/country:us/state:nc/county:davie/precinct:09
ocd-division/country:us/state:nc/county:davie/precinct:absentee	ocd-division/country:us/state:nc/county:davie/precinct:absentee
ocd-division/country:us/state:nc/county:jones/precinct:absentee	ocd-division/country:us/state:nc/county:jones/precinct:absentee
ocd-division/country:us/state:nc/county:jones/precinct:one_stop	ocd-division/country:us/state:nc/county:jones/precinct:one_stop
ocd-division/country:us/state:nc/county:franklin/precinct:1	ocd-division/country:us/state:nc/county:franklin/precinct:01
ocd-division/country:us/state:nc/county:franklin/precinct:2	ocd-division/country:us/state:nc/county:franklin/precinct:02
ocd-division/country:us/state:nc/county:franklin/precinct:3	ocd-division/country:us/state:nc/county:franklin/precinct:03
ocd-division/country:us/state:nc/county:franklin/precinct:5	ocd-division/country:us/state:nc/county:franklin/precinct:05
ocd-division/country:us/state:nc/county:franklin/precinct:6	ocd-division/country:us/state:nc/county:franklin/precinct:06
ocd-division/country:us/state:nc/county:franklin/precinct:7	ocd-division/country:us/state:nc/county:franklin/precinct:07
ocd-division/country:us/state:nc/county:franklin/precinct:8	ocd-division/country:us/state:nc/county:franklin/precinct:08
ocd-division/country:us/state:nc/county:franklin/precinct:9	ocd-division/country:us/state:nc/county:franklin/precinct:09
ocd-division/country:us/state:nc/county:carteret/precinct:absentee	ocd-division/country:us/state:nc/county:carteret/precinct:absentee
ocd-division/country:us/state:nc/county:carteret/precinct:atsl	ocd-division/country:us/state:nc/county:carteret/precinct:atln
ocd-division/country:us/state:nc/county:carteret/precinct:cisl	ocd-division/country:us/state:nc/county:carteret/precinct:cdis
ocd-division/country:us/state:nc/county:carteret/precinct:dasw	ocd-division/country:us/state:nc/county:carteret/precinct:davi
ocd-division/country:us/state:nc/county:carteret/precinct:masm	ocd-division/country:us/state:nc/county:carteret/precinct:mars
ocd-division/country:us/state:nc/county:carteret/precinct:os-boe	ocd-division/country:us/state:nc/county:carteret/precinct:one_stop
ocd-division/country:us/state:nc/county:carteret/precinct:os-cen	ocd-division/country:us/state:nc/county:carteret/precinct:one_stop
ocd-division/country:us/state:nc/county:carteret/precinct:os-eas	ocd-division/country:us/state:nc/county:carteret/precinct:one_stop
ocd-division/country:us/state:nc/county:carteret/precinct:os-mhd	ocd-division/country:us/state:nc/county:carteret/precinct:one_stop
ocd-division/country:us/state:nc/county:carteret/precinct:os-wes	ocd-division/country:us/state:nc/county:carteret/precinct:one_stop
ocd-division/country:us/state:nc/county:carteret/precinct:otbe	ocd-division/country:us/state:nc/county:carteret/precinct:otst
ocd-division/country:us/state:nc/county:carteret/precinct:wiha	ocd-division/country:us/state:nc/county:carteret/precinct:will
ocd-division/country:us/state:nc/county:lee/precinct:a1	ocd-division/country:us/state:nc/county:lee/precinct:a
ocd-division/country:us/state:nc/county:lee/precinct:a2	ocd-division/country:us/state:nc/county:lee/precinct:a
ocd-division/country:us/state:nc/county:lee/precinct:absentee	ocd-division/country:us/state:nc/county:lee/precinct:absentee
ocd-division/country:us/state:nc/county:lee/precinct:b1	ocd-division/country:us/state:nc/county:lee/precinct:b
ocd-division/country:us/state:nc/county:lee/precinct:b2	ocd-division/country:us/state:nc/county:lee/precinct:b
ocd-division/country:us/state:nc/county:lee/precinct:c1	ocd-division/country:us/state:nc/county:lee/precinct:c
ocd-division/country:us/state:nc/county:lee/precinct:c2	ocd-division/country:us/state:nc/county:lee/precinct:c
ocd-division/country:us/state:nc/county:lee/precinct:d1	ocd-division/country:us/state:nc/county:lee/precinct:d
ocd-division/country:us/state:nc/county:lee/precinct:d2	ocd-division/country:us/state:nc/county:lee/precinct:d
ocd-division/country:us/state:nc/county:lee/precinct:e1	ocd-division/country:us/state:nc/county:lee/precinct:e
ocd-division/country:us/state:nc/county:lee/precinct:e2	ocd-division/country:us/state:nc/county:lee/precinct:e
ocd-division/country:us/state:nc/county:lee/precinct:os-paper	ocd-division/country:us/state:nc/county:lee/precinct:one_stop
ocd-division/country:us/state:nc/county:cumberland/precinct:absentee_1-30	ocd-division/country:us/state:nc/county:cumberland/precinct:absentee
ocd-division/country:us/state:nc/county:cumberland/precinct:absentee_31-57	ocd-division/country:us/state:nc/county:cumberland/precinct:absentee
ocd-division/country:us/state:nc/county:cumberland/precinct:cl57-1	ocd-division/country:us/state:nc/county:cumberland/precinct:cl57
ocd-division/country:us/state:nc/county:cumberland/precinct:cl57-2	ocd-division/country:us/state:nc/county:cumberland/precinct:cl57
ocd-division/country:us/state:nc/county:cumberland/precinct:g10a	ocd-division/country:us/state:nc/county:cumberland/precinct:g10
ocd-division/country:us/state:nc/county:cumberland/precinct:g10b	ocd-division/country:us/state:nc/county:cumberland/precinct:g10
ocd-division/country:us/state:nc/county:cumberland/precinct:g10c	ocd-division/country:us/state:nc/county:cumberland/precinct:g10
ocd-division/country:us/state:nc/county:cumberland/precinct:g11a-1	ocd-division/country:us/state:nc/county:cumberland/precinct:g11
ocd-division/country:us/state:nc/county:cumberland/precinct:g11a-2	ocd-division/country:us/state:nc/county:cumberland/precinct:g11
ocd-division/country:us/state:nc/county:cumberland/precinct:g11b	ocd-division/country:us/state:nc/county:cumberland/precinct:g11
ocd-division/country:us/state:nc/county:cumberland/precinct:g1a	ocd-division/country:us/state:nc/county:cumberland/precinct:g1
ocd-division/country:us/state:nc/county:cumberland/precinct:g1b	ocd-division/country:us/state:nc/county:cumberland/precinct:g1
ocd-division/country:us/state:nc/county:cumberland/precinct:g2a	ocd-division/country:us/state:nc/county:cumberland/precinct:g2
ocd-division/country:us/state:nc/county:cumberland/precinct:g2b	ocd-division/country:us/state:nc/county:cumberland/precinct:g2
ocd-division/country:us/state:nc/county:cumberland/precinct:g2c-1	ocd-division/country:us/state:nc/county:cumberland/precinct:g2
ocd-division/country:us/state:nc/county:cumberland/precinct:g2c-2	ocd-division/country:us/state:nc/county:cumberland/precinct:g2
ocd-division/country:us/state:nc/county:cumberland/precinct:g2d	ocd-division/country:us/state:nc/county:cumberland/precinct:g2
ocd-division/country:us/state:nc/county:cumberland/precinct:g2e-1	ocd-division/country:us/state:nc/county:cumberland/precinct:g2
ocd-division/country:us/state:nc/county:cumberland/precinct:g2e-2	ocd-division/country:us/state:nc/county:cumberland/precinct:g2
ocd-division/country:us/state:nc/county:cumberland/precinct:g3a-1	ocd-division/country:us/state:nc/county:cumberland/precinct:g3
ocd-division/country:us/state:nc/county:cumberland/precinct:g3a-2	ocd-division/country:us/state:nc/county:cumberland/precinct:g3
ocd-division/country:us/state:nc/county:cumberland/precinct:g3b	ocd-division/country:us/state:nc/county:cumberland/precinct:g3
ocd-division/country:us/state:nc/county:cumberland/precinct:g3c	ocd-division/country:us/state:nc/county:cumberland/precinct:g3
ocd-division/country:us/state:nc/county:cumberland/precinct:g4a	ocd-division/country:us/state:nc/county:cumberland/precinct:g4
ocd-division/country:us/state:nc/county:cumberland/precinct:g4b	ocd-division/country:us/state:nc/county:cumberland/precinct:g4
ocd-division/country:us/state:nc/county:cumberland/precinct:g4c	ocd-division/country:us/state:nc/county:cumberland/precinct:g4
ocd-division/country:us/state:nc/county:cumberland/precinct:g5a-1	ocd-division/country:us/state:nc/county:cumberland/precinct:g5
ocd-division/country:us/state:nc/county:cumberland/precinct:g5a-2	ocd-division/country:us/state:nc/county:cumberland/precinct:g5
ocd-division/country:us/state:nc/county:cumberland/precinct:g5b-1	ocd-division/country:us/state:nc/county:cumberland/precinct:g5
ocd-division/country:us/state:nc/county:cumberland/precinct:g5b-2	ocd-division/country:us/state:nc/county:cumberland/precinct:g5
ocd-division/country:us/state:nc/county:cumberland/precinct:g5c	ocd-division/country:us/state:nc/county:cumberland/precinct:g5
ocd-division/country:us/state:nc/county:cumberland/precinct:g6a	ocd-division/country:us/state:nc/county:cumberland/precinct:g6
ocd-division/country:us/state:nc/county:cumberland/precinct:g6b	ocd-division/country:us/state:nc/county:cumberland/precinct:g6
ocd-division/country:us/state:nc/county:cumberland/precinct:g6c	ocd-division/country:us/state:nc/county:cumberland/precinct:g6
ocd-division/country:us/state:nc/county:cumberland/precinct:g7a	ocd-division/country:us/state:nc/county:cumberland/precinct:g7
ocd-division/country:us/state:nc/county:cumberland/precinct:g7b	ocd-division/country:us/state:nc/county:cumberland/precinct:g7
ocd-division/country:us/state:nc/county:cumberland/precinct:g8a	ocd-division/country:us/state:nc/county:cumberland/precinct:g8
ocd-division/country:us/state:nc/county:cumberland/precinct:g8b	ocd-division/country:us/state:nc/county:cumberland/precinct:g8
ocd-division/country:us/state:nc/county:cumberland/precinct:g8c	ocd-division/country:us/state:nc/county:cumberland/precinct:g8
ocd-division/country:us/state:nc/county:cumberland/precinct:g8d	ocd-division/country:us/state:nc/county:cumberland/precinct:g8
ocd-division/country:us/state:nc/county:cumberland/precinct:g9a	ocd-division/country:us/state:nc/county:cumberland/precinct:g9
ocd-division/country:us/state:nc/county:cumberland/precinct:g9b-1	ocd-division/country:us/state:nc/county:cumberland/precinct:g9
ocd-division/country:us/state:nc/county:cumberland/precinct:g9b-2	ocd-division/country:us/state:nc/county:cumberland/precinct:g9
ocd-division/country:us/state:nc/county:cumberland/precinct:one_stop_100_a_1-30	ocd-division/country:us/state:nc/county:cumberland/precinct:one_stop
ocd-division/country:us/state:nc/county:cumberland/precinct:one_stop_100_a_31-57	ocd-division/country:us/state:nc/county:cumberland/precinct:one_stop
ocd-division/country:us/state:nc/county:cumberland/precinct:one_stop_100_b_1-30	ocd-division/country:us/state:nc/county:cumberland/precinct:one_stop
ocd-division/country:us/state:nc/county:cumberland/precinct:one_stop_100_b_31-57	ocd-division/country:us/state:nc/county:cumberland/precinct:one_stop
ocd-division/country:us/state:nc/county:cumberland/precinct:one_stop_100_c_1-30	ocd-division/country:us/state:nc/county:cumberland/precinct:one_stop
ocd-division/country:us/state:nc/county:cumberland/precinct:one_stop_100_c_31-57	ocd-division/country:us/state:nc/county:cumberland/precinct:one_stop
ocd-division/country:us/state:nc/county:cumberland/precinct:one_stop_100_d_1-30	ocd-division/country:us/state:nc/county:cumberland/precinct:one_stop
ocd-division/country:us/state:nc/county:cumberland/precinct:one_stop_100_d_31-57	ocd-division/country:us/state:nc/county:cumberland/precinct:one_stop
ocd-division/country:us/state:nc/county:cumberland/precinct:one_stop_100_e_1-30	ocd-division/country:us/state:nc/county:cumberland/precinct:one_stop
ocd-division/country:us/state:nc/county:cumberland/precinct:one_stop_100_e_31-57	ocd-division/country:us/state:nc/county:cumberland/precinct:one_stop
ocd-division/country:us/state:nc/county:cumberland/precinct:one_stop_100_g_1-30	ocd-division/country:us/state:nc/county:cumberland/precinct:one_stop
ocd-division/country:us/state:nc/county:cumberland/precinct:one_stop_100_g_31-57	ocd-division/country:us/state:nc/county:cumberland/precinct:one_stop
ocd-division/country:us/state:nc/county:cumberland/precinct:one_stop_100_h_1-30	ocd-division/country:us/state:nc/county:cumberland/precinct:one_stop
ocd-division/country:us/state:nc/county:cumberland/precinct:one_stop_100_h_31-57	ocd-division/country:us/state:nc/county:cumberland/precinct:one_stop
ocd-division/country:us/state:nc/county:cumberland/precinct:one_stop_100_i_1-30	ocd-division/country:us/state:nc/county:cumberland/precinct:one_stop
ocd-division/country:us/state:nc/county:cumberland/precinct:one_stop_100_i_31-57	ocd-division/country:us/state:nc/county:cumberland/precinct:one_stop
ocd-division/country:us/state:nc/county:cumberland/precinct:one_stop_100_j_1-30	ocd-division/country:us/state:nc/county:cumberland/precinct:one_stop
ocd-division/country:us/state:nc/county:cumberland/precinct:one_stop_100_j_31-57	ocd-division/country:us/state:nc/county:cumberland/precinct:one_stop
ocd-division/country:us/state:nc/county:cumberland/precinct:one_stop_100_l_1-30	ocd-division/country:us/state:nc/county:cumberland/precinct:one_stop
ocd-division/country:us/state:nc/county:cumberland/precinct:one_stop_100_l_31-57	ocd-division/country:us/state:nc/county:cumberland/precinct:one_stop
ocd-division/country:us/state:nc/county:cumberland/precinct:provisional_1-30	ocd-division/country:us/state:nc/county:cumberland/precinct:provisional
ocd-division/country:us/state:nc/county:cumberland/precinct:provisional_31-57	ocd-division/country:us/state:nc/county:cumberland/precinct:provisional
ocd-division/country:us/state:nc/county:cumberland/precinct:transfer_1-30	ocd-division/country:us/state:nc/county:cumberland/precinct:provisional
ocd-division/country:us/state:nc/county:cumberland/precinct:transfer_31-57	ocd-division/country:us/state:nc/county:cumberland/precinct:provisional
ocd-division/country:us/state:nc/county:forsyth/precinct:11	ocd-division/country:us/state:nc/county:forsyth/precinct:011
ocd-division/country:us/state:nc/county:forsyth/precinct:12	ocd-division/country:us/state:nc/county:forsyth/precinct:012
ocd-division/country:us/state:nc/county:forsyth/precinct:13	ocd-division/country:us/state:nc/county:forsyth/precinct:013
ocd-division/country:us/state:nc/county:forsyth/precinct:14	ocd-division/country:us/state:nc/county:forsyth/precinct:014
ocd-division/country:us/state:nc/county:forsyth/precinct:15	ocd-division/country:us/state:nc/county:forsyth/precinct:015
ocd-division/country:us/state:nc/county:forsyth/precinct:21	ocd-division/country:us/state:nc/county:forsyth/precinct:021
ocd-division/country:us/state:nc/county:forsyth/precinct:31	ocd-division/country:us/state:nc/county:forsyth/precinct:031
ocd-division/country:us/state:nc/county:forsyth/precinct:32	ocd-division/country:us/state:nc/county:forsyth/precinct:032
ocd-division/country:us/state:nc/county:forsyth/precinct:33	ocd-division/country:us/state:nc/county:forsyth/precinct:033
ocd-division/country:us/state:nc/county:forsyth/precinct:34	ocd-division/country:us/state:nc/county:forsyth/precinct:034
ocd-division/country:us/state:nc/county:forsyth/precinct:42	ocd-division/country:us/state:nc/county:forsyth/precinct:042
ocd-division/country:us/state:nc/county:forsyth/precinct:43	ocd-division/country:us/state:nc/county:forsyth/precinct:043
ocd-division/country:us/state:nc/county:forsyth/precinct:51	ocd-division/country:us/state:nc/county:forsyth/precinct:051
ocd-division/country:us/state:nc/county:forsyth/precinct:52	ocd-division/country:us/state:nc/county:forsyth/precinct:052
ocd-division/country:us/state:nc/county:forsyth/precinct:53	ocd-division/country:us/state:nc/county:forsyth/precinct:053
ocd-division/country:us/state:nc/county:forsyth/precinct:54	ocd-division/country:us/state:nc/county:forsyth/precinct:054
ocd-division/country:us/state:nc/county:forsyth/precinct:55	ocd-division/country:us/state:nc/county:forsyth/precinct:055
ocd-division/country:us/state:nc/county:forsyth/precinct:61	ocd-division/country:us/state:nc/county:forsyth/precinct:061
ocd-division/country:us/state:nc/county:forsyth/precinct:62	ocd-division/country:us/state:nc/county:forsyth/precinct:062
ocd-division/country:us/state:nc/county:forsyth/precinct:63	ocd-division/country:us/state:nc/county:forsyth/precinct:063
ocd-division/country:us/state:nc/county:forsyth/precinct:64	ocd-division/country:us/state:nc/county:forsyth/precinct:064
ocd-division/country:us/state:nc/county:forsyth/precinct:65	ocd-division/country:us/state:nc/county:forsyth/precinct:065
ocd-division/country:us/state:nc/county:forsyth/precinct:66	ocd-division/country:us/state:nc/county:forsyth/precinct:066
ocd-division/country:us/state:nc/county:forsyth/precinct:67	ocd-division/country:us/state:nc/county:forsyth/precinct:067
ocd-division/country:us/state:nc/county:forsyth/precinct:68	ocd-division/country:us/state:nc/county:forsyth/precinct:068
ocd-division/country:us/state:nc/county:forsyth/precinct:71	ocd-division/country:us/state:nc/county:forsyth/precinct:071
ocd-division/country:us/state:nc/county:forsyth/precinct:72	ocd-division/country:us/state:nc/county:forsyth/precinct:072
ocd-division/country:us/state:nc/county:forsyth/precinct:73	ocd-division/country:us/state:nc/county:forsyth/precinct:073
ocd-division/country:us/state:nc/county:forsyth/precinct:74	ocd-division/country:us/state:nc/county:forsyth/precinct:074
ocd-division/country:us/state:nc/county:forsyth/precinct:75	ocd-division/country:us/state:nc/county:forsyth/precinct:075
ocd-division/country:us/state:nc/county:forsyth/precinct:81	ocd-division/country:us/state:nc/county:forsyth/precinct:081
ocd-division/country:us/state:nc/county:forsyth/precinct:82	ocd-division/country:us/state:nc/county:forsyth/precinct:082
ocd-division/country:us/state:nc/county:forsyth/precinct:83	ocd-division/country:us/state:nc/county:forsyth/precinct:083
ocd-division/country:us/state:nc/county:forsyth/precinct:91	ocd-division/country:us/state:nc/county:forsyth/precinct:091
ocd-division/country:us/state:nc/county:forsyth/precinct:92	ocd-division/country:us/state:nc/county:forsyth/precinct:092
ocd-division/country:us/state:nc/county:forsyth/precinct:abs~prov~curb_1	ocd-division/country:us/state:nc/county:forsyth/precinct:absentee
ocd-division/country:us/state:nc/county:forsyth/precinct:abs~prov~curb_2	ocd-division/country:us/state:nc/county:forsyth/precinct:absentee
ocd-division/country:us/state:nc/county:forsyth/precinct:abs~prov~curb_3	ocd-division/country:us/state:nc/county:forsyth/precinct:absentee
ocd-division/country:us/state:nc/county:forsyth/precinct:abs~prov~curb_4	ocd-division/country:us/state:nc/county:forsyth/precinct:absentee
ocd-division/country:us/state:nc/county:durham/precinct:1	ocd-division/country:us/state:nc/county:durham/precinct:01
ocd-division/country:us/state:nc/county:durham/precinct:2	ocd-division/country:us/state:nc/county:durham/precinct:02
ocd-division/country:us/state:nc/county:durham/precinct:3	ocd-division/country:us/state:nc/county:durham/precinct:03
ocd-division/country:us/state:nc/county:durham/precinct:34-1	ocd-division/country:us/state:nc/county:durham/precinct:34
ocd-division/country:us/state:nc/county:durham/precinct:34-2	ocd-division/country:us/state:nc/county:durham/precinct:34
ocd-division/country:us/state:nc/county:durham/precinct:35.3	ocd-division/country:us/state:nc/county:durham/precinct:35
ocd-division/country:us/state:nc/county:durham/precinct:4	ocd-division/country:us/state:nc/county:durham/precinct:04
ocd-division/country:us/state:nc/county:durham/precinct:5	ocd-division/country:us/state:nc/county:durham/precinct:05
ocd-division/country:us/state:nc/county:durham/precinct:55-11	ocd-division/country:us/state:nc/county:durham/precinct:55
ocd-division/country:us/state:nc/county:durham/precinct:55-49	ocd-division/country:us/state:nc/county:durham/precinct:55
ocd-division/country:us/state:nc/county:durham/precinct:6	ocd-division/country:us/state:nc/county:durham/precinct:06
ocd-division/country:us/state:nc/county:durham/precinct:7	ocd-division/country:us/state:nc/county:durham/precinct:07
ocd-division/country:us/state:nc/county:durham/precinct:8	ocd-division/country:us/state:nc/county:durham/precinct:08
ocd-division/country:us/state:nc/county:durham/precinct:9	ocd-division/country:us/state:nc/county:durham/precinct:09
ocd-division/country:us/state:nc/county:durham/precinct:absentee	ocd-division/country:us/state:nc/county:durham/precinct:absentee
ocd-division/country:us/state:nc/county:durham/precinct:os-boe	ocd-division/country:us/state:nc/county:durham/precinct:one_stop
ocd-division/country:us/state:nc/county:durham/precinct:os-dtc	ocd-division/country:us/state:nc/county:durham/precinct:one_stop
ocd-division/country:us/state:nc/county:durham/precinct:os-dtcn	ocd-division/country:us/state:nc/county:durham/precinct:one_stop
ocd-division/country:us/state:nc/county:durham/precinct:os-duke	ocd-division/country:us/state:nc/county:durham/precinct:one_stop
ocd-division/country:us/state:nc/county:durham/precinct:os-eno	ocd-division/country:us/state:nc/county:durham/precinct:one_stop
ocd-division/country:us/state:nc/county:durham/precinct:os-erl	ocd-division/country:us/state:nc/county:durham/precinct:one_stop
ocd-division/country:us/state:nc/county:durham/precinct:os-front	ocd-division/country:us/state:nc/county:durham/precinct:one_stop
ocd-division/country:us/state:nc/county:durham/precinct:os-getg	ocd-division/country:us/state:nc/county:durham/precinct:one_stop
ocd-division/country:us/state:nc/county:durham/precinct:os-ivy	ocd-division/country:us/state:nc/county:durham/precinct:one_stop
ocd-division/country:us/state:nc/county:durham/precinct:os-nccu	ocd-division/country:us/state:nc/county:durham/precinct:one_stop
ocd-division/country:us/state:nc/county:durham/precinct:os-njbc	ocd-division/country:us/state:nc/county:durham/precinct:one_stop
ocd-division/country:us/state:nc/county:durham/precinct:os-nrl	ocd-division/country:us/state:nc/county:durham/precinct:one_stop
ocd-division/country:us/state:nc/county:durham/precinct:os-srl	ocd-division/country:us/state:nc/county:durham/precinct:one_stop
ocd-division/country:us/state:nc/county:burke/precinct:1	ocd-division/country:us/state:nc/county:burke/precinct:0001
ocd-division/country:us/state:nc/county:burke/precinct:11	ocd-division/country:us/state:nc/county:burke/precinct:0011
ocd-division/country:us/state:nc/county:burke/precinct:12	ocd-division/country:us/state:nc/county:burke/precinct:0012
ocd-division/country:us/state:nc/county:burke/precinct:13	ocd-division/country:us/state:nc/county:burke/precinct:0013
ocd-division/country:us/state:nc/county:burke/precinct:14	ocd-division/country:us/state:nc/county:burke/precinct:0014
ocd-division/country:us/state:nc/county:burke/precinct:15	ocd-division/country:us/state:nc/county:burke/precinct:0015
ocd-division/country:us/state:nc/county:burke/precinct:18	ocd-division/country:us/state:nc/county:burke/precinct:0018
ocd-division/country:us/state:nc/county:burke/precinct:19	ocd-division/country:us/state:nc/county:burke/precinct:0019
ocd-division/country:us/state:nc/county:burke/precinct:20	ocd-division/country:us/state:nc/county:burke/precinct:0020
ocd-division/country:us/state:nc/county:burke/precinct:21	ocd-division/country:us/state:nc/county:burke/precinct:0021
ocd-division/country:us/state:nc/county:burke/precinct:22	ocd-division/country:us/state:nc/county:burke/precinct:0022
ocd-division/country:us/state:nc/county:burke/precinct:24	ocd-division/country:us/state:nc/county:burke/precinct:0024
ocd-division/country:us/state:nc/county:burke/precinct:29-a	ocd-division/country:us/state:nc/county:burke/precinct:0029
ocd-division/country:us/state:nc/county:burke/precinct:29-b	ocd-division/country:us/state:nc/county:burke/precinct:0029
ocd-division/country:us/state:nc/county:burke/precinct:3	ocd-division/country:us/state:nc/county:burke/precinct:0003
ocd-division/country:us/state:nc/county:burke/precinct:31	ocd-division/country:us/state:nc/county:burke/precinct:0031
ocd-division/country:us/state:nc/county:burke/precinct:34	ocd-division/country:us/state:nc/county:burke/precinct:0034
ocd-division/country:us/state:nc/county:burke/precinct:35	ocd-division/country:us/state:nc/county:burke/precinct:0035
ocd-division/country:us/state:nc/county:burke/precinct:36	ocd-division/country:us/state:nc/county:burke/precinct:0036
ocd-division/country:us/state:nc/county:burke/precinct:38	ocd-division/country:us/state:nc/county:burke/precinct:0038
ocd-division/country:us/state:nc/county:burke/precinct:39	ocd-division/country:us/state:nc/county:burke/precinct:0039
ocd-division/country:us/state:nc/county:burke/precinct:40	ocd-division/country:us/state:nc/county:burke/precinct:0040
ocd-division/country:us/state:nc/county:burke/precinct:47-a	ocd-division/country:us/state:nc/county:burke/precinct:0047
ocd-division/country:us/state:nc/county:burke/precinct:47-b	ocd-division/country:us/state:nc/county:burke/precinct:0047
ocd-division/country:us/state:nc/county:burke/precinct:48	ocd-division/country:us/state:nc/county:burke/precinct:0048
ocd-division/country:us/state:nc/county:burke/precinct:51	ocd-division/country:us/state:nc/county:burke/precinct:0051
ocd-division/country:us/state:nc/county:burke/precinct:52	ocd-division/country:us/state:nc/county:burke/precinct:0052
ocd-division/country:us/state:nc/county:burke/precinct:53	ocd-division/country:us/state:nc/county:burke/precinct:0053
ocd-division/country:us/state:nc/county:burke/precinct:62	ocd-division/country:us/state:nc/county:burke/precinct:0062
ocd-division/country:us/state:nc/county:burke/precinct:64	ocd-division/country:us/state:nc/county:burke/precinct:0064
ocd-division/country:us/state:nc/county:burke/precinct:65	ocd-division/country:us/state:nc/county:burke/precinct:0065
ocd-division/country:us/state:nc/county:burke/precinct:66	ocd-division/country:us/state:nc/county:burke/precinct:0066
ocd-division/country:us/state:nc/county:burke/precinct:70	ocd-division/country:us/state:nc/county:burke/precinct:0070
ocd-division/country:us/state:nc/county:burke/precinct:absentee	ocd-division/country:us/state:nc/county:burke/precinct:absentee
ocd-division/country:us/state:nc/county:bertie/precinct:absentee	ocd-division/country:us/state:nc/county:bertie/precinct:absentee
ocd-division/country:us/state:nc/county:bertie/precinct:os-lob	ocd-division/country:us/state:nc/county:bertie/precinct:one_stop
ocd-division/country:us/state:nc/county:bertie/precinct:os-pow	ocd-division/country:us/state:nc/county:bertie/precinct:one_stop
ocd-division/country:us/state:nc/county:dare/precinct:absentee	ocd-division/country:us/state:nc/county:dare/precinct:absentee
ocd-division/country:us/state:nc/county:union/precinct:1	ocd-division/country:us/state:nc/county:union/precinct:001
ocd-division/country:us/state:nc/county:union/precinct:10	ocd-division/country:us/state:nc/county:union/precinct:010
ocd-division/country:us/state:nc/county:union/precinct:11	ocd-division/country:us/state:nc/county:union/precinct:011
ocd-division/country:us/state:nc/county:union/precinct:12	ocd-division/country:us/state:nc/county:union/precinct:012
ocd-division/country:us/state:nc/county:union/precinct:13	ocd-division/country:us/state:nc/county:union/precinct:013
ocd-division/country:us/state:nc/county:union/precinct:14	ocd-division/country:us/state:nc/county:union/precinct:014
ocd-division/country:us/state:nc/county:union/precinct:15	ocd-division/country:us/state:nc/county:union/precinct:015
ocd-division/country:us/state:nc/county:union/precinct:16	ocd-division/country:us/state:nc/county:union/precinct:016
ocd-division/country:us/state:nc/county:union/precinct:17a	ocd-division/country:us/state:nc/county:union/precinct:017a
ocd-division/country:us/state:nc/county:union/precinct:17b	ocd-division/country:us/state:nc/county:union/precinct:017b
ocd-division/country:us/state:nc/county:union/precinct:18	ocd-division/country:us/state:nc/county:union/precinct:018
ocd-division/country:us/state:nc/county:union/precinct:19	ocd-division/country:us/state:nc/county:union/precinct:019
ocd-division/country:us/state:nc/county:union/precinct:2	ocd-division/country:us/state:nc/county:union/precinct:002
ocd-division/country:us/state:nc/county:union/precinct:20a	ocd-division/country:us/state:nc/county:union/precinct:020a
ocd-division/country:us/state:nc/county:union/precinct:20b	ocd-division/country:us/state:nc/county:union/precinct:020b
ocd-division/country:us/state:nc/county:union/precinct:21	ocd-division/country:us/state:nc/county:union/precinct:021
ocd-division/country:us/state:nc/county:union/precinct:22	ocd-division/country:us/state:nc/county:union/precinct:022
ocd-division/country:us/state:nc/county:union/precinct:23	ocd-division/country:us/state:nc/county:union/precinct:023
ocd-division/country:us/state:nc/county:union/precinct:24	ocd-division/country:us/state:nc/county:union/precinct:024
ocd-division/country:us/state:nc/county:union/precinct:25	ocd-division/country:us/state:nc/county:union/precinct:025
ocd-division/country:us/state:nc/county:union/precinct:26	ocd-division/country:us/state:nc/county:union/precinct:026
ocd-division/country:us/state:nc/county:union/precinct:27	ocd-division/country:us/state:nc/county:union/precinct:027
ocd-division/country:us/state:nc/county:union/precinct:28a	ocd-division/country:us/state:nc/county:union/precinct:028
ocd-division/country:us/state:nc/county:union/precinct:28b	ocd-division/country:us/state:nc/county:union/precinct:028
ocd-division/country:us/state:nc/county:union/precinct:28c	ocd-division/country:us/state:nc/county:union/precinct:028
ocd-division/country:us/state:nc/county:union/precinct:28d	ocd-division/country:us/state:nc/county:union/precinct:028
ocd-division/country:us/state:nc/county:union/precinct:29a	ocd-division/country:us/state:nc/county:union/precinct:029a
ocd-division/country:us/state:nc/county:union/precinct:29b	ocd-division/country:us/state:nc/county:union/precinct:029b
ocd-division/country:us/state:nc/county:union/precinct:29c	ocd-division/country:us/state:nc/county:union/precinct:029c
ocd-division/country:us/state:nc/county:union/precinct:3	ocd-division/country:us/state:nc/county:union/precinct:003
ocd-division/country:us/state:nc/county:union/precinct:30	ocd-division/country:us/state:nc/county:union/precinct:030
ocd-division/country:us/state:nc/county:union/precinct:31	ocd-division/country:us/state:nc/county:union/precinct:031
ocd-division/country:us/state:nc/county:union/precinct:32	ocd-division/country:us/state:nc/county:union/precinct:032
ocd-division/country:us/state:nc/county:union/precinct:33	ocd-division/country:us/state:nc/county:union/precinct:033
ocd-division/country:us/state:nc/county:union/precinct:34	ocd-division/country:us/state:nc/county:union/precinct:034
ocd-division/country:us/state:nc/county:union/precinct:35	ocd-division/country:us/state:nc/county:union/precinct:035
ocd-division/country:us/state:nc/county:union/precinct:36	ocd-division/country:us/state:nc/county:union/precinct:036
ocd-division/country:us/state:nc/county:union/precinct:37a	ocd-division/country:us/state:nc/county:union/precinct:037a
ocd-division/country:us/state:nc/county:union/precinct:37b	ocd-division/country:us/state:nc/county:union/precinct:037b
ocd-division/country:us/state:nc/county:union/precinct:38a	ocd-division/country:us/state:nc/county:union/precinct:038a
ocd-division/country:us/state:nc/county:union/precinct:38b	ocd-division/country:us/state:nc/county:union/precinct:038b
ocd-division/country:us/state:nc/county:union/precinct:39	ocd-division/country:us/state:nc/county:union/precinct:039
ocd-division/country:us/state:nc/county:union/precinct:4	ocd-division/country:us/state:nc/county:union/precinct:004
ocd-division/country:us/state:nc/county:union/precinct:40	ocd-division/country:us/state:nc/county:union/precinct:040
ocd-division/country:us/state:nc/county:union/precinct:41	ocd-division/country:us/state:nc/county:union/precinct:041
ocd-division/country:us/state:nc/county:union/precinct:42	ocd-division/country:us/state:nc/county:union/precinct:042
ocd-division/country:us/state:nc/county:union/precinct:43	ocd-division/country:us/state:nc/county:union/precinct:043
ocd-division/country:us/state:nc/county:union/precinct:5	ocd-division/country:us/state:nc/county:union/precinct:005
ocd-division/country:us/state:nc/county:union/precinct:6	ocd-division/country:us/state:nc/county:union/precinct:006
ocd-division/country:us/state:nc/county:union/precinct:7	ocd-division/country:us/state:nc/county:union/precinct:007
ocd-division/country:us/state:nc/county:union/precinct:8	ocd-division/country:us/state:nc/county:union/precinct:008
ocd-division/country:us/state:nc/county:union/precinct:9	ocd-division/country:us/state:nc/county:union/precinct:009
ocd-division/country:us/state:nc/county:union/precinct:absentee	ocd-division/country:us/state:nc/county:union/precinct:absentee
ocd-division/country:us/state:nc/county:guilford/precinct:abs~curb~prov_4	ocd-division/country:us/state:nc/county:guilford/precinct:absentee
ocd-division/country:us/state:nc/county:guilford/precinct:abs~prov~curb_1	ocd-division/country:us/state:nc/county:guilford/precinct:absentee
ocd-division/country:us/state:nc/county:guilford/precinct:abs~prov~curb_2	ocd-division/country:us/state:nc/county:guilford/precinct:absentee
ocd-division/country:us/state:nc/county:guilford/precinct:abs~prov~curb_3	ocd-division/country:us/state:nc/county:guilford/precinct:absentee
ocd-division/country:us/state:nc/county:guilford/precinct:fr5a	ocd-division/country:us/state:nc/county:guilford/precinct:fr5
ocd-division/country:us/state:nc/county:guilford/precinct:fr5b	ocd-division/country:us/state:nc/county:guilford/precinct:fr5
ocd-division/country:us/state:nc/county:guilford/precinct:g41a	ocd-division/country:us/state:nc/county:guilford/precinct:g41
ocd-division/country:us/state:nc/county:guilford/precinct:g41b	ocd-division/country:us/state:nc/county:guilford/precinct:g41
ocd-division/country:us/state:nc/county:guilford/precinct:g42a	ocd-division/country:us/state:nc/county:guilford/precinct:g42
ocd-division/country:us/state:nc/county:guilford/precinct:g42b	ocd-division/country:us/state:nc/county:guilford/precinct:g42
ocd-division/country:us/state:nc/county:guilford/precinct:h27-a	ocd-division/country:us/state:nc/county:guilford/precinct:h27
ocd-division/country:us/state:nc/county:guilford/precinct:h27-b	ocd-division/country:us/state:nc/county:guilford/precinct:h27
ocd-division/country:us/state:nc/county:guilford/precinct:h28	ocd-division/country:us/state:nc/county:guilford/precinct:hp
ocd-division/country:us/state:nc/county:guilford/precinct:h29a	ocd-division/country:us/state:nc/county:guilford/precinct:hp
ocd-division/country:us/state:nc/county:guilford/precinct:h29b	ocd-division/country:us/state:nc/county:guilford/precinct:hp
ocd-division/country:us/state:nc/county:guilford/precinct:mon2a	ocd-division/country:us/state:nc/county:guilford/precinct:mon2
ocd-division/country:us/state:nc/county:guilford/precinct:mon2b	ocd-division/country:us/state:nc/county:guilford/precinct:mon2
ocd-division/country:us/state:nc/county:cleveland/precinct:br	ocd-division/country:us/state:nc/county:cleveland/precinct:bspgs
ocd-division/country:us/state:nc/county:cleveland/precinct:km_n	ocd-division/country:us/state:nc/county:cleveland/precinct:km1
ocd-division/country:us/state:nc/county:cleveland/precinct:km_s	ocd-division/country:us/state:nc/county:cleveland/precinct:km4
ocd-division/country:us/state:nc/county:cleveland/precinct:oakgrv	ocd-division/country:us/state:nc/county:cleveland/precinct:oakgr
ocd-division/country:us/state:nc/county:cleveland/precinct:s_4a	ocd-division/country:us/state:nc/county:cleveland/precinct:s4
ocd-division/country:us/state:nc/county:cleveland/precinct:s_5	ocd-division/country:us/state:nc/county:cleveland/precinct:s5
ocd-division/country:us/state:nc/county:cleveland/precinct:s_c	ocd-division/country:us/state:nc/county:cleveland/precinct:s6
ocd-division/country:us/state:nc/county:cleveland/precinct:s_s	ocd-division/country:us/state:nc/county:cleveland/precinct:s7
ocd-division/country:us/state:nc/county:stokes/precinct:1	ocd-division/country:us/state:nc/county:stokes/precinct:01
ocd-division/country:us/state:nc/county:stokes/precinct:2	ocd-division/country:us/state:nc/county:stokes/precinct:02
ocd-division/country:us/state:nc/county:stokes/precinct:3	ocd-division/country:us/state:nc/county:stokes/precinct:03
ocd-division/country:us/state:nc/county:stokes/precinct:4	ocd-division/country:us/state:nc/county:stokes/precinct:04
ocd-division/country:us/state:nc/county:stokes/precinct:5	ocd-division/country:us/state:nc/county:stokes/precinct:05
ocd-division/country:us/state:nc/county:stokes/precinct:6	ocd-division/country:us/state:nc/county:stokes/precinct:06
ocd-division/country:us/state:nc/county:stokes/precinct:7	ocd-division/country:us/state:nc/county:stokes/precinct:07
ocd-division/country:us/state:nc/county:stokes/precinct:8	ocd-division/country:us/state:nc/county:stokes/precinct:08
ocd-division/country:us/state:nc/county:stokes/precinct:9	ocd-division/country:us/state:nc/county:stokes/precinct:09
ocd-division/country:us/state:nc/county:stokes/precinct:absentee	ocd-division/country:us/state:nc/county:stokes/precinct:absentee
ocd-division/country:us/state:nc/county:stokes/precinct:os_danbury	ocd-division/country:us/state:nc/county:stokes/precinct:one_stop
ocd-division/country:us/state:nc/county:stokes/precinct:os_king	ocd-division/country:us/state:nc/county:stokes/precinct:one_stop
ocd-division/country:us/state:nc/county:stokes/precinct:os_walnut_cove	ocd-division/country:us/state:nc/county:stokes/precinct:one_stop
ocd-division/country:us/state:nc/county:transylvania/precinct:tc1	ocd-division/country:us/state:nc/county:transylvania/precinct:bg
ocd-division/country:us/state:nc/county:transylvania/precinct:tc7	ocd-division/country:us/state:nc/county:transylvania/precinct:lt
ocd-division/country:us/state:nc/county:stanly/precinct:10	ocd-division/country:us/state:nc/county:stanly/precinct:0010
ocd-division/country:us/state:nc/county:stanly/precinct:11	ocd-division/country:us/state:nc/county:stanly/precinct:0011
ocd-division/country:us/state:nc/county:stanly/precinct:12	ocd-division/country:us/state:nc/county:stanly/precinct:0012
ocd-division/country:us/state:nc/county:stanly/precinct:13	ocd-division/country:us/state:nc/county:stanly/precinct:0013
ocd-division/country:us/state:nc/county:stanly/precinct:14	ocd-division/country:us/state:nc/county:stanly/precinct:0014
ocd-division/country:us/state:nc/county:stanly/precinct:15	ocd-division/country:us/state:nc/county:stanly/precinct:0015
ocd-division/country:us/state:nc/county:stanly/precinct:16	ocd-division/country:us/state:nc/county:stanly/precinct:0016
ocd-division/country:us/state:nc/county:stanly/precinct:17	ocd-division/country:us/state:nc/county:stanly/precinct:0017
ocd-division/country:us/state:nc/county:stanly/precinct:18	ocd-division/country:us/state:nc/county:stanly/precinct:0018
ocd-division/country:us/state:nc/county:stanly/precinct:19	ocd-division/country:us/state:nc/county:stanly/precinct:0019
ocd-division/country:us/state:nc/county:stanly/precinct:2	ocd-division/country:us/state:nc/county:stanly/precinct:0002
ocd-division/country:us/state:nc/county:stanly/precinct:20	ocd-division/country:us/state:nc/county:stanly/precinct:0020
ocd-division/country:us/state:nc/county:stanly/precinct:21	ocd-division/country:us/state:nc/county:stanly/precinct:0021
ocd-division/country:us/state:nc/county:stanly/precinct:22	ocd-division/country:us/state:nc/county:stanly/precinct:0022
ocd-division/country:us/state:nc/county:stanly/precinct:23	ocd-division/country:us/state:nc/county:stanly/precinct:0023
ocd-division/country:us/state:nc/county:stanly/precinct:24	ocd-division/country:us/state:nc/county:stanly/precinct:0024
ocd-division/country:us/state:nc/county:stanly/precinct:25	ocd-division/country:us/state:nc/county:stanly/precinct:0025
ocd-division/country:us/state:nc/county:stanly/precinct:26	ocd-division/country:us/state:nc/county:stanly/precinct:0026
ocd-division/country:us/state:nc/county:stanly/precinct:27	ocd-division/country:us/state:nc/county:stanly/precinct:0027
ocd-division/country:us/state:nc/county:stanly/precinct:28	ocd-division/country:us/state:nc/county:stanly/precinct:0028
ocd-division/country:us/state:nc/county:stanly/precinct:3	ocd-division/country:us/state:nc/county:stanly/precinct:0003
ocd-division/country:us/state:nc/county:stanly/precinct:7	ocd-division/country:us/state:nc/county:stanly/precinct:0007
ocd-division/country:us/state:nc/county:stanly/precinct:8	ocd-division/country:us/state:nc/county:stanly/precinct:0008
ocd-division/country:us/state:nc/county:davidson/precinct:4	ocd-division/country:us/state:nc/county:davidson/precinct:04
ocd-division/country:us/state:nc/county:davidson/precinct:6	ocd-division/country:us/state:nc/county:davidson/precinct:06
ocd-division/country:us/state:nc/county:davidson/precinct:8	ocd-division/country:us/state:nc/county:davidson/precinct:08
ocd-division/country:us/state:nc/county:davidson/precinct:80a	ocd-division/country:us/state:nc/county:davidson/precinct:80
ocd-division/country:us/state:nc/county:davidson/precinct:86a	ocd-division/country:us/state:nc/county:davidson/precinct:80
ocd-division/country:us/state:nc/county:davidson/precinct:88	ocd-division/country:us/state:nc/county:davidson/precinct:80
ocd-division/country:us/state:nc/county:davidson/precinct:absentee	ocd-division/country:us/state:nc/county:davidson/precinct:absentee
ocd-division/country:us/state:nc/county:greene/precinct:absentee	ocd-division/country:us/state:nc/county:greene/precinct:absentee
ocd-division/country:us/state:nc/county:greene/precinct:one_stop	ocd-division/country:us/state:nc/county:greene/precinct:one_stop
ocd-division/country:us/state:nc/county:greene/precinct:sh~1	ocd-division/country:us/state:nc/county:greene/precinct:sh1
ocd-division/country:us/state:nc/county:ashe/precinct:2	ocd-division/country:us/state:nc/county:ashe/precinct:02
ocd-division/country:us/state:nc/county:ashe/precinct:3	ocd-division/country:us/state:nc/county:ashe/precinct:03
ocd-division/country:us/state:nc/county:ashe/precinct:4	ocd-division/country:us/state:nc/county:ashe/precinct:04
ocd-division/country:us/state:nc/county:ashe/precinct:6	ocd-division/country:us/state:nc/county:ashe/precinct:06
ocd-division/country:us/state:nc/county:ashe/precinct:7	ocd-division/country:us/state:nc/county:ashe/precinct:07
ocd-division/country:us/state:nc/county:ashe/precinct:8	ocd-division/country:us/state:nc/county:ashe/precinct:08
ocd-division/country:us/state:nc/county:ashe/precinct:9	ocd-division/country:us/state:nc/county:ashe/precinct:09
ocd-division/country:us/state:nc/county:ashe/precinct:absentee	ocd-division/country:us/state:nc/county:ashe/precinct:absentee
ocd-division/country:us/state:nc/county:ashe/precinct:one_stop	ocd-division/country:us/state:nc/county:ashe/precinct:one_stop
ocd-division/country:us/state:nc/county:polk/precinct:absentee	ocd-division/country:us/state:nc/county:polk/precinct:absentee
ocd-division/country:us/state:nc/county:gaston/precinct:1	ocd-division/country:us/state:nc/county:gaston/precinct:01
ocd-division/country:us/state:nc/county:gaston/precinct:2	ocd-division/country:us/state:nc/county:gaston/precinct:02
ocd-division/country:us/state:nc/county:gaston/precinct:3	ocd-division/country:us/state:nc/county:gaston/precinct:03
ocd-division/country:us/state:nc/county:gaston/precinct:4	ocd-division/country:us/state:nc/county:gaston/precinct:04
ocd-division/country:us/state:nc/county:gaston/precinct:5	ocd-division/country:us/state:nc/county:gaston/precinct:05
ocd-division/country:us/state:nc/county:gaston/precinct:6	ocd-division/country:us/state:nc/county:gaston/precinct:06
ocd-division/country:us/state:nc/county:gaston/precinct:7	ocd-division/country:us/state:nc/county:gaston/precinct:07
ocd-division/country:us/state:nc/county:gaston/precinct:8	ocd-division/country:us/state:nc/county:gaston/precinct:08
ocd-division/country:us/state:nc/county:gaston/precinct:9	ocd-division/country:us/state:nc/county:gaston/precinct:09
ocd-division/country:us/state:nc/county:gaston/precinct:absentee	ocd-division/country:us/state:nc/county:gaston/precinct:absentee
ocd-division/country:us/state:nc/county:gaston/precinct:os-boe	ocd-division/country:us/state:nc/county:gaston/precinct:one_stop
ocd-division/country:us/state:nc/county:gaston/precinct:os-cherryville	ocd-division/country:us/state:nc/county:gaston/precinct:one_stop
ocd-division/country:us/state:nc/county:gaston/precinct:os-dallas	ocd-division/country:us/state:nc/county:gaston/precinct:one_stop
ocd-division/country:us/state:nc/county:gaston/precinct:os-fbc_gastonia	ocd-division/country:us/state:nc/county:gaston/precinct:one_stop
ocd-division/country:us/state:nc/county:gaston/precinct:os-library	ocd-division/country:us/state:nc/county:gaston/precinct:one_stop
ocd-division/country:us/state:nc/county:gaston/precinct:os-mount_holly	ocd-division/country:us/state:nc/county:gaston/precinct:one_stop
ocd-division/country:us/state:nc/county:onslow/precinct:absentee	ocd-division/country:us/state:nc/county:onslow/precinct:absentee
ocd-division/country:us/state:nc/county:onslow/precinct:ne22a	ocd-division/country:us/state:nc/county:onslow/precinct:ne22
ocd-division/country:us/state:nc/county:onslow/precinct:ne22b	ocd-division/country:us/state:nc/county:onslow/precinct:ne22
ocd-division/country:us/state:nc/county:onslow/precinct:os-commons_rec_ctr	ocd-division/country:us/state:nc/county:onslow/precinct:one_stop
ocd-division/country:us/state:nc/county:onslow/precinct:os-onslow_office	ocd-division/country:us/state:nc/county:onslow/precinct:one_stop
ocd-division/country:us/state:nc/county:onslow/precinct:os-swansboro_rotary	ocd-division/country:us/state:nc/county:onslow/precinct:one_stop
ocd-division/country:us/state:nc/county:onslow/precinct:os-verona	ocd-division/country:us/state:nc/county:onslow/precinct:one_stop
ocd-division/country:us/state:nc/county:buncombe/precinct:1.1	ocd-division/country:us/state:nc/county:buncombe/precinct:01.1
ocd-division/country:us/state:nc/county:buncombe/precinct:14.3	ocd-division/country:us/state:nc/county:buncombe/precinct:14.2
ocd-division/country:us/state:nc/county:buncombe/precinct:16.2	ocd-division/country:us/state:nc/county:buncombe/precinct:17.1
ocd-division/country:us/state:nc/county:buncombe/precinct:18.2	ocd-division/country:us/state:nc/county:buncombe/precinct:19.1
ocd-division/country:us/state:nc/county:buncombe/precinct:2.1	ocd-division/country:us/state:nc/county:buncombe/precinct:02.1
ocd-division/country:us/state:nc/county:buncombe/precinct:21.1	ocd-division/country:us/state:nc/county:buncombe/precinct:20.1
ocd-division/country:us/state:nc/county:buncombe/precinct:22.2	ocd-division/country:us/state:nc/county:buncombe/precinct:20.1
ocd-division/country:us/state:nc/county:buncombe/precinct:23.2	ocd-division/country:us/state:nc/county:buncombe/precinct:24.1
ocd-division/country:us/state:nc/county:buncombe/precinct:23.3	ocd-division/country:us/state:nc/county:buncombe/precinct:24.1
ocd-division/country:us/state:nc/county:buncombe/precinct:27.2	ocd-division/country:us/state:nc/county:buncombe/precinct:26.1
ocd-division/country:us/state:nc/county:buncombe/precinct:29.2	ocd-division/country:us/state:nc/county:buncombe/precinct:30.1
ocd-division/country:us/state:nc/county:buncombe/precinct:3.1	ocd-division/country:us/state:nc/county:buncombe/precinct:03.1
ocd-division/country:us/state:nc/county:buncombe/precinct:30.2	ocd-division/country:us/state:nc/county:buncombe/precinct:30.1
ocd-division/country:us/state:nc/county:buncombe/precinct:30.3	ocd-division/country:us/state:nc/county:buncombe/precinct:30.1
ocd-division/country:us/state:nc/county:buncombe/precinct:39.2	ocd-division/country:us/state:nc/county:buncombe/precinct:39.1
ocd-division/country:us/state:nc/county:buncombe/precinct:39.3	ocd-division/country:us/state:nc/county:buncombe/precinct:39.1
ocd-division/country:us/state:nc/county:buncombe/precinct:4.1	ocd-division/country:us/state:nc/county:buncombe/precinct:04.1
ocd-division/country:us/state:nc/county:buncombe/precinct:40.2	ocd-division/country:us/state:nc/county:buncombe/precinct:41.1
ocd-division/country:us/state:nc/county:buncombe/precinct:42.1	ocd-division/country:us/state:nc/county:buncombe/precinct:41.1
ocd-division/country:us/state:nc/county:buncombe/precinct:43.2	ocd-division/country:us/state:nc/county:buncombe/precinct:44.1
ocd-division/country:us/state:nc/county:buncombe/precinct:5.1	ocd-division/country:us/state:nc/county:buncombe/precinct:05.1
ocd-division/country:us/state:nc/county:buncombe/precinct:51.2	ocd-division/country:us/state:nc/county:buncombe/precinct:50.1
ocd-division/country:us/state:nc/county:buncombe/precinct:54.2	ocd-division/country:us/state:nc/county:buncombe/precinct:53.1
ocd-division/country:us/state:nc/county:buncombe/precinct:56.2	ocd-division/country:us/state:nc/county:buncombe/precinct:55.1
ocd-division/country:us/state:nc/county:buncombe/precinct:6.1	ocd-division/country:us/state:nc/county:buncombe/precinct:06.1
ocd-division/country:us/state:nc/county:buncombe/precinct:60.4	ocd-division/country:us/state:nc/county:buncombe/precinct:60.2
ocd-division/country:us/state:nc/county:buncombe/precinct:681	ocd-division/country:us/state:nc/county:buncombe/precinct:68.1
ocd-division/country:us/state:nc/county:buncombe/precinct:7.1	ocd-division/country:us/state:nc/county:buncombe/precinct:07.1
ocd-division/country:us/state:nc/county:buncombe/precinct:8.2	ocd-division/country:us/state:nc/county:buncombe/precinct:07.1
ocd-division/country:us/state:nc/county:buncombe/precinct:8.3	ocd-division/country:us/state:nc/county:buncombe/precinct:07.1
ocd-division/country:us/state:nc/county:buncombe/precinct:9.1	ocd-division/country:us/state:nc/county:buncombe/precinct:09.1
ocd-division/country:us/state:nc/county:buncombe/precinct:absentee	ocd-division/country:us/state:nc/county:buncombe/precinct:absentee
ocd-division/country:us/state:nc/county:buncombe/precinct:os_abtc	ocd-division/country:us/state:nc/county:buncombe/precinct:one_stop
ocd-division/country:us/state:nc/county:buncombe/precinct:os_accc	ocd-division/country:us/state:nc/county:buncombe/precinct:one_stop
ocd-division/country:us/state:nc/county:buncombe/precinct:os_avml	ocd-division/country:us/state:nc/county:buncombe/precinct:one_stop
ocd-division/country:us/state:nc/county:buncombe/precinct:os_bmbl	ocd-division/country:us/state:nc/county:buncombe/precinct:one_stop
ocd-division/country:us/state:nc/county:buncombe/precinct:os_btfd	ocd-division/country:us/state:nc/county:buncombe/precinct:one_stop
ocd-division/country:us/state:nc/county:buncombe/precinct:os_ecbl	ocd-division/country:us/state:nc/county:buncombe/precinct:one_stop
ocd-division/country:us/state:nc/county:buncombe/precinct:os_fcam	ocd-division/country:us/state:nc/county:buncombe/precinct:one_stop
ocd-division/country:us/state:nc/county:buncombe/precinct:os_fvbl	ocd-division/country:us/state:nc/county:buncombe/precinct:one_stop
ocd-division/country:us/state:nc/county:buncombe/precinct:os_lcbl	ocd-division/country:us/state:nc/county:buncombe/precinct:one_stop
ocd-division/country:us/state:nc/county:buncombe/precinct:os_morc	ocd-division/country:us/state:nc/county:buncombe/precinct:one_stop
ocd-division/country:us/state:nc/county:buncombe/precinct:os_nabl	ocd-division/country:us/state:nc/county:buncombe/precinct:one_stop
ocd-division/country:us/state:nc/county:buncombe/precinct:os_nhpc	ocd-division/country:us/state:nc/county:buncombe/precinct:one_stop
ocd-division/country:us/state:nc/county:buncombe/precinct:os_pack	ocd-division/country:us/state:nc/county:buncombe/precinct:one_stop
ocd-division/country:us/state:nc/county:buncombe/precinct:os_pcbc	ocd-division/country:us/state:nc/county:buncombe/precinct:one_stop
ocd-division/country:us/state:nc/county:buncombe/precinct:os_sbbl	ocd-division/country:us/state:nc/county:buncombe/precinct:one_stop
ocd-division/country:us/state:nc/county:buncombe/precinct:os_unca	ocd-division/country:us/state:nc/county:buncombe/precinct:one_stop
ocd-division/country:us/state:nc/county:buncombe/precinct:os_wabl	ocd-division/country:us/state:nc/county:buncombe/precinct:one_stop
ocd-division/country:us/state:nc/county:buncombe/precinct:os_wgsc	ocd-division/country:us/state:nc/county:buncombe/precinct:one_stop
ocd-division/country:us/state:nc/county:buncombe/precinct:os_woco	ocd-division/country:us/state:nc/county:buncombe/precinct:one_stop
ocd-division/country:us/state:nc/county:buncombe/precinct:os_wvth	ocd-division/country:us/state:nc/county:buncombe/precinct:one_stop
ocd-division/country:us/state:nc/county:cabarrus/precinct:1-02	ocd-division/country:us/state:nc/county:cabarrus/precinct:01-02
ocd-division/country:us/state:nc/county:cabarrus/precinct:1-04	ocd-division/country:us/state:nc/county:cabarrus/precinct:01-04
ocd-division/country:us/state:nc/county:cabarrus/precinct:1-06	ocd-division/country:us/state:nc/county:cabarrus/precinct:01-06
ocd-division/country:us/state:nc/county:cabarrus/precinct:1-07	ocd-division/country:us/state:nc/county:cabarrus/precinct:01-07
ocd-division/country:us/state:nc/county:cabarrus/precinct:1-08	ocd-division/country:us/state:nc/county:cabarrus/precinct:01-08
ocd-division/country:us/state:nc/county:cabarrus/precinct:1-09	ocd-division/country:us/state:nc/county:cabarrus/precinct:01-09
ocd-division/country:us/state:nc/county:cabarrus/precinct:1-10	ocd-division/country:us/state:nc/county:cabarrus/precinct:01-10
ocd-division/country:us/state:nc/county:cabarrus/precinct:2-01	ocd-division/country:us/state:nc/county:cabarrus/precinct:02-01
ocd-division/country:us/state:nc/county:cabarrus/precinct:2-02	ocd-division/country:us/state:nc/county:cabarrus/precinct:02-02
ocd-division/country:us/state:nc/county:cabarrus/precinct:2-03	ocd-division/country:us/state:nc/county:cabarrus/precinct:02-03
ocd-division/country:us/state:nc/county:cabarrus/precinct:2-05	ocd-division/country:us/state:nc/county:cabarrus/precinct:02-05
ocd-division/country:us/state:nc/county:cabarrus/precinct:2-06	ocd-division/country:us/state:nc/county:cabarrus/precinct:02-06
ocd-division/country:us/state:nc/county:cabarrus/precinct:2-07	ocd-division/country:us/state:nc/county:cabarrus/precinct:02-07
ocd-division/country:us/state:nc/county:cabarrus/precinct:2-08	ocd-division/country:us/state:nc/county:cabarrus/precinct:02-08
ocd-division/country:us/state:nc/county:cabarrus/precinct:2-09	ocd-division/country:us/state:nc/county:cabarrus/precinct:02-09
ocd-division/country:us/state:nc/county:cabarrus/precinct:3-00	ocd-division/country:us/state:nc/county:cabarrus/precinct:03-00
ocd-division/country:us/state:nc/county:cabarrus/precinct:4-01	ocd-division/country:us/state:nc/county:cabarrus/precinct:04-01
ocd-division/country:us/state:nc/county:cabarrus/precinct:4-02	ocd-division/country:us/state:nc/county:cabarrus/precinct:04-02
ocd-division/country:us/state:nc/county:cabarrus/precinct:4-03	ocd-division/country:us/state:nc/county:cabarrus/precinct:04-03
ocd-division/country:us/state:nc/county:cabarrus/precinct:4-04	ocd-division/country:us/state:nc/county:cabarrus/precinct:04-04
ocd-division/country:us/state:nc/county:cabarrus/precinct:4-05	ocd-division/country:us/state:nc/county:cabarrus/precinct:04-05
ocd-division/country:us/state:nc/county:cabarrus/precinct:4-06	ocd-division/country:us/state:nc/county:cabarrus/precinct:04-06
ocd-division/country:us/state:nc/county:cabarrus/precinct:4-07	ocd-division/country:us/state:nc/county:cabarrus/precinct:04-07
ocd-division/country:us/state:nc/county:cabarrus/precinct:4-08	ocd-division/country:us/state:nc/county:cabarrus/precinct:04-08
ocd-division/country:us/state:nc/county:cabarrus/precinct:4-09	ocd-division/country:us/state:nc/county:cabarrus/precinct:04-09
ocd-division/country:us/state:nc/county:cabarrus/precinct:4-10	ocd-division/country:us/state:nc/county:cabarrus/precinct:04-10
ocd-division/country:us/state:nc/county:cabarrus/precinct:5-00	ocd-division/country:us/state:nc/county:cabarrus/precinct:05-00
ocd-division/country:us/state:nc/county:cabarrus/precinct:6-00	ocd-division/country:us/state:nc/county:cabarrus/precinct:06-00
ocd-division/country:us/state:nc/county:cabarrus/precinct:7-00	ocd-division/country:us/state:nc/county:cabarrus/precinct:07-00
ocd-division/country:us/state:nc/county:cabarrus/precinct:8-00	ocd-division/country:us/state:nc/county:cabarrus/precinct:08-00
ocd-division/country:us/state:nc/county:cabarrus/precinct:9-00	ocd-division/country:us/state:nc/county:cabarrus/precinct:09-00
ocd-division/country:us/state:nc/county:cabarrus/precinct:absentee	ocd-division/country:us/state:nc/county:cabarrus/precinct:absentee
ocd-division/country:us/state:nc/county:cabarrus/precinct:os-cbb	ocd-division/country:us/state:nc/county:cabarrus/precinct:one_stop
ocd-division/country:us/state:nc/county:cabarrus/precinct:os-cfs	ocd-division/country:us/state:nc/county:cabarrus/precinct:one_stop
ocd-division/country:us/state:nc/county:cabarrus/precinct:os-hbl	ocd-division/country:us/state:nc/county:cabarrus/precinct:one_stop
ocd-division/country:us/state:nc/county:cabarrus/precinct:os-lob	ocd-division/country:us/state:nc/county:cabarrus/precinct:one_stop
ocd-division/country:us/state:nc/county:avery/precinct:1	ocd-division/country:us/state:nc/county:avery/precinct:01
ocd-division/country:us/state:nc/county:avery/precinct:2	ocd-division/country:us/state:nc/county:avery/precinct:02
ocd-division/country:us/state:nc/county:avery/precinct:3	ocd-division/country:us/state:nc/county:avery/precinct:03
ocd-division/country:us/state:nc/county:avery/precinct:4	ocd-division/country:us/state:nc/county:avery/precinct:04
ocd-division/country:us/state:nc/county:avery/precinct:5	ocd-division/country:us/state:nc/county:avery/precinct:05
ocd-division/country:us/state:nc/county:avery/precinct:6	ocd-division/country:us/state:nc/county:avery/precinct:06
ocd-division/country:us/state:nc/county:avery/precinct:7	ocd-division/country:us/state:nc/county:avery/precinct:07
ocd-division/country:us/state:nc/county:avery/precinct:8	ocd-division/country:us/state:nc/county:avery/precinct:08
ocd-division/country:us/state:nc/county:avery/precinct:9	ocd-division/country:us/state:nc/county:avery/precinct:09
ocd-division/country:us/state:nc/county:avery/precinct:absentee	ocd-division/country:us/state:nc/county:avery/precinct:absentee
ocd-division/country:us/state:nc/county:avery/precinct:one_stop	ocd-division/country:us/state:nc/county:avery/precinct:one_stop
ocd-division/country:us/state:nc/county:yadkin/precinct:absentee	ocd-division/country:us/state:nc/county:yadkin/precinct:absentee
ocd-division/country:us/state:nc/county:yadkin/precinct:one_stop	ocd-division/country:us/state:nc/county:yadkin/precinct:one_stop
ocd-division/country:us/state:nc/county:haywood/precinct:absentee	ocd-division/country:us/state:nc/county:haywood/precinct:absentee
ocd-division/country:us/state:nc/county:orange/precinct:os_boe	ocd-division/country:us/state:nc/county:orange/precinct:one_stop
ocd-division/country:us/state:nc/county:orange/precinct:os_cotc	ocd-division/country:us/state:nc/county:orange/precinct:one_stop
ocd-division/country:us/state:nc/county:orange/precinct:os_cth	ocd-division/country:us/state:nc/county:orange/precinct:one_stop
ocd-division/country:us/state:nc/county:orange/precinct:os_efland	ocd-division/country:us/state:nc/county:orange/precinct:one_stop
ocd-division/country:us/state:nc/county:orange/precinct:os_seymour	ocd-division/country:us/state:nc/county:orange/precinct:one_stop
ocd-division/country:us/state:nc/county:orange/precinct:wds	ocd-division/country:us/state:nc/county:orange/precinct:one_stop
ocd-division/country:us/state:nc/county:pasquotank/precinct:absentee	ocd-division/country:us/state:nc/county:pasquotank/precinct:absentee
ocd-division/country:us/state:nc/county:pasquotank/precinct:east	ocd-division/country:us/state:nc/county:pasquotank/precinct:1-a
ocd-division/country:us/state:nc/county:pasquotank/precinct:north	ocd-division/country:us/state:nc/county:pasquotank/precinct:2-a
ocd-division/country:us/state:nc/county:pasquotank/precinct:one_stop	ocd-division/country:us/state:nc/county:pasquotank/precinct:one_stop
ocd-division/country:us/state:nc/county:pasquotank/precinct:south	ocd-division/country:us/state:nc/county:pasquotank/precinct:3-a
ocd-division/country:us/state:nc/county:pasquotank/precinct:west	ocd-division/country:us/state:nc/county:pasquotank/precinct:4-a
ocd-division/country:us/state:nc/county:edgecombe/precinct:101	ocd-division/country:us/state:nc/county:edgecombe/precinct:0101
ocd-division/country:us/state:nc/county:edgecombe/precinct:102	ocd-division/country:us/state:nc/county:edgecombe/precinct:0102
ocd-division/country:us/state:nc/county:edgecombe/precinct:103	ocd-division/country:us/state:nc/county:edgecombe/precinct:0103
ocd-division/country:us/state:nc/county:edgecombe/precinct:104	ocd-division/country:us/state:nc/county:edgecombe/precinct:0104
ocd-division/country:us/state:nc/county:edgecombe/precinct:201	ocd-division/country:us/state:nc/county:edgecombe/precinct:0201
ocd-division/country:us/state:nc/county:edgecombe/precinct:301	ocd-division/country:us/state:nc/county:edgecombe/precinct:0301
ocd-division/country:us/state:nc/county:edgecombe/precinct:401	ocd-division/country:us/state:nc/county:edgecombe/precinct:0401
ocd-division/country:us/state:nc/county:edgecombe/precinct:501	ocd-division/country:us/state:nc/county:edgecombe/precinct:0501
ocd-division/country:us/state:nc/county:edgecombe/precinct:601	ocd-division/country:us/state:nc/county:edgecombe/precinct:0601
ocd-division/country:us/state:nc/county:edgecombe/precinct:701	ocd-division/country:us/state:nc/county:edgecombe/precinct:0701
ocd-division/country:us/state:nc/county:edgecombe/precinct:801	ocd-division/country:us/state:nc/county:edgecombe/precinct:0801
ocd-division/country:us/state:nc/county:edgecombe/precinct:901	ocd-division/country:us/state:nc/county:edgecombe/precinct:0901
ocd-division/country:us/state:nc/county:edgecombe/precinct:absentee	ocd-division/country:us/state:nc/county:edgecombe/precinct:absentee
ocd-division/country:us/state:nc/county:edgecombe/precinct:one_stop_1	ocd-division/country:us/state:nc/county:edgecombe/precinct:one_stop
ocd-division/country:us/state:nc/county:edgecombe/precinct:one_stop_2	ocd-division/country:us/state:nc/county:edgecombe/precinct:one_stop
ocd-division/country:us/state:nc/county:edgecombe/precinct:one_stop_3	ocd-division/country:us/state:nc/county:edgecombe/precinct:one_stop
ocd-division/country:us/state:nc/county:edgecombe/precinct:one_stop_4	ocd-division/country:us/state:nc/county:edgecombe/precinct:one_stop
ocd-division/country:us/state:nc/county:edgecombe/precinct:one_stop_5	ocd-division/country:us/state:nc/county:edgecombe/precinct:one_stop
ocd-division/country:us/state:nc/county:edgecombe/precinct:one_stop_6	ocd-division/country:us/state:nc/county:edgecombe/precinct:one_stop
ocd-division/country:us/state:nc/county:columbus/precinct:absentee	ocd-division/country:us/state:nc/county:columbus/precinct:absentee
ocd-division/country:us/state:nc/county:columbus/precinct:os_bolton	ocd-division/country:us/state:nc/county:columbus/precinct:one_stop
ocd-division/country:us/state:nc/county:columbus/precinct:os_chadbourn	ocd-division/country:us/state:nc/county:columbus/precinct:one_stop
ocd-division/country:us/state:nc/county:columbus/precinct:os_east_columbus	ocd-division/country:us/state:nc/county:columbus/precinct:one_stop
ocd-division/country:us/state:nc/county:columbus/precinct:os_fair_bluff	ocd-division/country:us/state:nc/county:columbus/precinct:one_stop
ocd-division/country:us/state:nc/county:columbus/precinct:os_lobby	ocd-division/country:us/state:nc/county:columbus/precinct:one_stop
ocd-division/country:us/state:nc/county:columbus/precinct:os_tabor_city	ocd-division/country:us/state:nc/county:columbus/precinct:one_stop
ocd-division/country:us/state:nc/county:columbus/precinct:p01a	ocd-division/country:us/state:nc/county:columbus/precinct:p01
ocd-division/country:us/state:nc/county:columbus/precinct:p02b	ocd-division/country:us/state:nc/county:columbus/precinct:p02
ocd-division/country:us/state:nc/county:columbus/precinct:p16b	ocd-division/country:us/state:nc/county:columbus/precinct:p16
ocd-division/country:us/state:nc/county:columbus/precinct:p20a	ocd-division/country:us/state:nc/county:columbus/precinct:p20
ocd-division/country:us/state:nc/county:columbus/precinct:p22a	ocd-division/country:us/state:nc/county:columbus/precinct:p22
ocd-division/country:us/state:nc/county:columbus/precinct:p25b	ocd-division/country:us/state:nc/county:columbus/precinct:p25
ocd-division/country:us/state:nc/county:columbus/precinct:p26b	ocd-division/country:us/state:nc/county:columbus/precinct:p26
ocd-division/country:us/state:nc/county:madison/precinct:ebbs_c	ocd-division/country:us/state:nc/county:madison/precinct:ebbs-c
ocd-division/country:us/state:nc/county:madison/precinct:hot_sp	ocd-division/country:us/state:nc/county:madison/precinct:hot-sp
ocd-division/country:us/state:nc/county:madison/precinct:mars_h	ocd-division/country:us/state:nc/county:madison/precinct:mars-h
ocd-division/country:us/state:nc/county:camden/precinct:absentee	ocd-division/country:us/state:nc/county:camden/precinct:absentee
ocd-division/country:us/state:nc/county:camden/precinct:one_stop	ocd-division/country:us/state:nc/county:camden/precinct:one_stop
ocd-division/country:us/state:nc/county:wayne/precinct:1	ocd-division/country:us/state:nc/county:wayne/precinct:01
ocd-division/country:us/state:nc/county:wayne/precinct:2	ocd-division/country:us/state:nc/county:wayne/precinct:02
ocd-division/country:us/state:nc/county:wayne/precinct:3	ocd-division/country:us/state:nc/county:wayne/precinct:03
ocd-division/country:us/state:nc/county:wayne/precinct:4	ocd-division/country:us/state:nc/county:wayne/precinct:04
ocd-division/country:us/state:nc/county:wayne/precinct:5	ocd-division/country:us/state:nc/county:wayne/precinct:05
ocd-division/country:us/state:nc/county:wayne/precinct:6	ocd-division/country:us/state:nc/county:wayne/precinct:06
ocd-division/country:us/state:nc/county:wayne/precinct:7	ocd-division/country:us/state:nc/county:wayne/precinct:07
ocd-division/country:us/state:nc/county:wayne/precinct:8	ocd-division/country:us/state:nc/county:wayne/precinct:08
ocd-division/country:us/state:nc/county:wayne/precinct:9	ocd-division/country:us/state:nc/county:wayne/precinct:09
ocd-division/country:us/state:nc/county:wayne/precinct:absentee	ocd-division/country:us/state:nc/county:wayne/precinct:absentee
ocd-division/country:us/state:nc/county:wayne/precinct:one_stop_boe	ocd-division/country:us/state:nc/county:wayne/precinct:one_stop
ocd-division/country:us/state:nc/county:wayne/precinct:one_stop_fth	ocd-division/country:us/state:nc/county:wayne/precinct:one_stop
ocd-division/country:us/state:nc/county:wayne/precinct:one_stop_gwc	ocd-division/country:us/state:nc/county:wayne/precinct:one_stop
ocd-division/country:us/state:nc/county:wayne/precinct:one_stop_lrs	ocd-division/country:us/state:nc/county:wayne/precinct:one_stop
ocd-division/country:us/state:nc/county:wayne/precinct:one_stop_mot	ocd-division/country:us/state:nc/county:wayne/precinct:one_stop
ocd-division/country:us/state:nc/county:wayne/precinct:one_stop_nhf	ocd-division/country:us/state:nc/county:wayne/precinct:one_stop
ocd-division/country:us/state:nc/county:pitt/precinct:101	ocd-division/country:us/state:nc/county:pitt/precinct:0101
ocd-division/country:us/state:nc/county:pitt/precinct:1403a1	ocd-division/country:us/state:nc/county:pitt/precinct:1403a
ocd-division/country:us/state:nc/county:pitt/precinct:1403a2	ocd-division/country:us/state:nc/county:pitt/precinct:1403a
ocd-division/country:us/state:nc/county:pitt/precinct:1504a	ocd-division/country:us/state:nc/county:pitt/precinct:1504
ocd-division/country:us/state:nc/county:pitt/precinct:1504b	ocd-division/country:us/state:nc/county:pitt/precinct:1504
ocd-division/country:us/state:nc/county:pitt/precinct:1513a	ocd-division/country:us/state:nc/county:pitt/precinct:1512b
ocd-division/country:us/state:nc/county:pitt/precinct:1513b	ocd-division/country:us/state:nc/county:pitt/precinct:1512b
ocd-division/country:us/state:nc/county:pitt/precinct:200a	ocd-division/country:us/state:nc/county:pitt/precinct:0200a
ocd-division/country:us/state:nc/county:pitt/precinct:200b	ocd-division/country:us/state:nc/county:pitt/precinct:0200b
ocd-division/country:us/state:nc/county:pitt/precinct:301	ocd-division/country:us/state:nc/county:pitt/precinct:0301
ocd-division/country:us/state:nc/county:pitt/precinct:401	ocd-division/country:us/state:nc/county:pitt/precinct:0401
ocd-division/country:us/state:nc/county:pitt/precinct:501	ocd-division/country:us/state:nc/county:pitt/precinct:0501
ocd-division/country:us/state:nc/county:pitt/precinct:601	ocd-division/country:us/state:nc/county:pitt/precinct:0601
ocd-division/country:us/state:nc/county:pitt/precinct:701	ocd-division/country:us/state:nc/county:pitt/precinct:0701
ocd-division/country:us/state:nc/county:pitt/precinct:800a	ocd-division/country:us/state:nc/county:pitt/precinct:0800a
ocd-division/country:us/state:nc/county:pitt/precinct:800b	ocd-division/country:us/state:nc/county:pitt/precinct:0800b
ocd-division/country:us/state:nc/county:pitt/precinct:901	ocd-division/country:us/state:nc/county:pitt/precinct:0901
ocd-division/country:us/state:nc/county:pitt/precinct:absentee_~1	ocd-division/country:us/state:nc/county:pitt/precinct:absentee
ocd-division/country:us/state:nc/county:pitt/precinct:absentee_~2	ocd-division/country:us/state:nc/county:pitt/precinct:absentee
ocd-division/country:us/state:nc/county:pitt/precinct:os_ag_center_1	ocd-division/country:us/state:nc/county:pitt/precinct:one_stop
ocd-division/country:us/state:nc/county:pitt/precinct:os_ag_center_2	ocd-division/country:us/state:nc/county:pitt/precinct:one_stop
ocd-division/country:us/state:nc/county:pitt/precinct:os_ayden_~1	ocd-division/country:us/state:nc/county:pitt/precinct:one_stop
ocd-division/country:us/state:nc/county:pitt/precinct:os_ayden_~2	ocd-division/country:us/state:nc/county:pitt/precinct:one_stop
ocd-division/country:us/state:nc/county:pitt/precinct:os_community_schools_1	ocd-division/country:us/state:nc/county:pitt/precinct:one_stop
ocd-division/country:us/state:nc/county:pitt/precinct:os_community_schools_2	ocd-division/country:us/state:nc/county:pitt/precinct:one_stop
ocd-division/country:us/state:nc/county:pitt/precinct:os_county_office_1	ocd-division/country:us/state:nc/county:pitt/precinct:one_stop
ocd-division/country:us/state:nc/county:pitt/precinct:os_county_office_2	ocd-division/country:us/state:nc/county:pitt/precinct:one_stop
ocd-division/country:us/state:nc/county:pitt/precinct:os_ecu-willis_bldg_1	ocd-division/country:us/state:nc/county:pitt/precinct:one_stop
ocd-division/country:us/state:nc/county:pitt/precinct:os_farmville_1	ocd-division/country:us/state:nc/county:pitt/precinct:one_stop
ocd-division/country:us/state:nc/county:pitt/precinct:os_farmville_2	ocd-division/country:us/state:nc/county:pitt/precinct:one_stop
ocd-division/country:us/state:nc/county:pitt/precinct:os_willis_building_~2	ocd-division/country:us/state:nc/county:pitt/precinct:one_stop
ocd-division/country:us/state:nc/county:pitt/precinct:os_winterville_~1	ocd-division/country:us/state:nc/county:pitt/precinct:one_stop
ocd-division/country:us/state:nc/county:pitt/precinct:os_winterville_~2	ocd-division/country:us/state:nc/county:pitt/precinct:one_stop
ocd-division/country:us/state:nc/county:pitt/precinct:provisional_~1	ocd-division/country:us/state:nc/county:pitt/precinct:provisional
ocd-division/country:us/state:nc/county:pitt/precinct:provisional_~2	ocd-division/country:us/state:nc/county:pitt/precinct:provisional
ocd-division/country:us/state:nc/county:pitt/precinct:transfer_~1	ocd-division/country:us/state:nc/county:pitt/precinct:provisional
ocd-division/country:us/state:nc/county:pitt/precinct:transfer_~2	ocd-division/country:us/state:nc/county:pitt/precinct:provisional
ocd-division/country:us/state:nc/county:new_hanover/precinct:absentee	ocd-division/country:us/state:nc/county:new_hanover/precinct:absentee
ocd-division/country:us/state:nc/county:new_hanover/precinct:cf01	ocd-division/country:us/state:nc/county:new hanover/precinct:cf01
ocd-division/country:us/state:nc/county:new_hanover/precinct:cf02	ocd-division/country:us/state:nc/county:new hanover/precinct:cf02
ocd-division/country:us/state:nc/county:new_hanover/precinct:cf05	ocd-division/country:us/state:nc/county:new hanover/precinct:cf03
ocd-division/country:us/state:nc/county:new_hanover/precinct:cf06	ocd-division/country:us/state:nc/county:new hanover/precinct:cf03
ocd-division/country:us/state:nc/county:new_hanover/precinct:fp03	ocd-division/country:us/state:nc/county:new hanover/precinct:fp03
ocd-division/country:us/state:nc/county:new_hanover/precinct:fp04	ocd-division/country:us/state:nc/county:new hanover/precinct:fp04
ocd-division/country:us/state:nc/county:new_hanover/precinct:fp06	ocd-division/country:us/state:nc/county:new hanover/precinct:fp05
ocd-division/country:us/state:nc/county:new_hanover/precinct:fp07	ocd-division/country:us/state:nc/county:new hanover/precinct:fp05
ocd-division/country:us/state:nc/county:new_hanover/precinct:fp08	ocd-division/country:us/state:nc/county:new hanover/precinct:fp05
ocd-division/country:us/state:nc/county:new_hanover/precinct:h01	ocd-division/country:us/state:nc/county:new hanover/precinct:h01
ocd-division/country:us/state:nc/county:new_hanover/precinct:h02	ocd-division/country:us/state:nc/county:new hanover/precinct:h02
ocd-division/country:us/state:nc/county:new_hanover/precinct:h03	ocd-division/country:us/state:nc/county:new hanover/precinct:h03
ocd-division/country:us/state:nc/county:new_hanover/precinct:h04	ocd-division/country:us/state:nc/county:new hanover/precinct:h04
ocd-division/country:us/state:nc/county:new_hanover/precinct:h05	ocd-division/country:us/state:nc/county:new hanover/precinct:h05
ocd-division/country:us/state:nc/county:new_hanover/precinct:h06	ocd-division/country:us/state:nc/county:new hanover/precinct:h06
ocd-division/country:us/state:nc/county:new_hanover/precinct:h08	ocd-division/country:us/state:nc/county:new hanover/precinct:h08
ocd-division/country:us/state:nc/county:new_hanover/precinct:h10	ocd-division/country:us/state:nc/county:new hanover/precinct:h09
ocd-division/country:us/state:nc/county:new_hanover/precinct:h11	ocd-division/country:us/state:nc/county:new hanover/precinct:h09
ocd-division/country:us/state:nc/county:new_hanover/precinct:h12	ocd-division/country:us/state:nc/county:new hanover/precinct:h09
ocd-division/country:us/state:nc/county:new_hanover/precinct:h13	ocd-division/country:us/state:nc/county:new hanover/precinct:h09
ocd-division/country:us/state:nc/county:new_hanover/precinct:m02	ocd-division/country:us/state:nc/county:new hanover/precinct:m02
ocd-division/country:us/state:nc/county:new_hanover/precinct:m03	ocd-division/country:us/state:nc/county:new hanover/precinct:m03
ocd-division/country:us/state:nc/county:new_hanover/precinct:m04	ocd-division/country:us/state:nc/county:new hanover/precinct:m04
ocd-division/country:us/state:nc/county:new_hanover/precinct:m06	ocd-division/country:us/state:nc/county:new hanover/precinct:m05
ocd-division/country:us/state:nc/county:new_hanover/precinct:m07	ocd-division/country:us/state:nc/county:new hanover/precinct:m05
ocd-division/country:us/state:nc/county:new_hanover/precinct:os_cab_paper	ocd-division/country:us/state:nc/county:new_hanover/precinct:one_stop
ocd-division/country:us/state:nc/county:new_hanover/precinct:os_cfcc_paper	ocd-division/country:us/state:nc/county:new_hanover/precinct:one_stop
ocd-division/country:us/state:nc/county:new_hanover/precinct:os_gvt_paper	ocd-division/country:us/state:nc/county:new_hanover/precinct:one_stop
ocd-division/country:us/state:nc/county:new_hanover/precinct:os_nlb_paper	ocd-division/country:us/state:nc/county:new_hanover/precinct:one_stop
ocd-division/country:us/state:nc/county:new_hanover/precinct:os_src_paper	ocd-division/country:us/state:nc/county:new_hanover/precinct:one_stop
ocd-division/country:us/state:nc/county:new_hanover/precinct:w03	ocd-division/country:us/state:nc/county:new hanover/precinct:w03
ocd-division/country:us/state:nc/county:new_hanover/precinct:w08	ocd-division/country:us/state:nc/county:new hanover/precinct:w08
ocd-division/country:us/state:nc/county:new_hanover/precinct:w12	ocd-division/country:us/state:nc/county:new hanover/precinct:w12
ocd-division/country:us/state:nc/county:new_hanover/precinct:w13	ocd-division/country:us/state:nc/county:new hanover/precinct:w13
ocd-division/country:us/state:nc/county:new_hanover/precinct:w15	ocd-division/country:us/state:nc/county:new hanover/precinct:w15
ocd-division/country:us/state:nc/county:new_hanover/precinct:w16	ocd-division/country:us/state:nc/county:new hanover/precinct:w16
ocd-division/country:us/state:nc/county:new_hanover/precinct:w17	ocd-division/country:us/state:nc/county:new hanover/precinct:w17
ocd-division/country:us/state:nc/county:new_hanover/precinct:w18	ocd-division/country:us/state:nc/county:new hanover/precinct:w18
ocd-division/country:us/state:nc/county:new_hanover/precinct:w21	ocd-division/country:us/state:nc/county:new hanover/precinct:w21
ocd-division/country:us/state:nc/county:new_hanover/precinct:w24	ocd-division/country:us/state:nc/county:new hanover/precinct:w24
ocd-division/country:us/state:nc/county:new_hanover/precinct:w25	ocd-division/country:us/state:nc/county:new hanover/precinct:w25
ocd-division/country:us/state:nc/county:new_hanover/precinct:w26	ocd-division/country:us/state:nc/county:new hanover/precinct:w26
ocd-division/country:us/state:nc/county:new_hanover/precinct:w27	ocd-division/country:us/state:nc/county:new hanover/precinct:w27
ocd-division/country:us/state:nc/county:new_hanover/precinct:w28	ocd-division/country:us/state:nc/county:new hanover/precinct:w28
ocd-division/country:us/state:nc/county:new_hanover/precinct:w29	ocd-division/country:us/state:nc/county:new hanover/precinct:w29
ocd-division/country:us/state:nc/county:new_hanover/precinct:w30	ocd-division/country:us/state:nc/county:new hanover/precinct:w30
ocd-division/country:us/state:nc/county:new_hanover/precinct:w31	ocd-division/country:us/state:nc/county:new hanover/precinct:w31
ocd-division/country:us/state:nc/county:new_hanover/precinct:wb	ocd-division/country:us/state:nc/county:new hanover/precinct:wb
ocd-division/country:us/state:nc/county:martin/precinct:absentee	ocd-division/country:us/state:nc/county:martin/precinct:absentee
ocd-division/country:us/state:nc/county:martin/precinct:one_stop	ocd-division/country:us/state:nc/county:martin/precinct:one_stop
ocd-division/country:us/state:nc/county:robeson/precinct:1	ocd-division/country:us/state:nc/county:robeson/precinct:01
ocd-division/country:us/state:nc/county:robeson/precinct:11a	ocd-division/country:us/state:nc/county:robeson/precinct:11
ocd-division/country:us/state:nc/county:robeson/precinct:2	ocd-division/country:us/state:nc/county:robeson/precinct:02
ocd-division/country:us/state:nc/county:robeson/precinct:26a	ocd-division/country:us/state:nc/county:robeson/precinct:26
ocd-division/country:us/state:nc/county:robeson/precinct:3	ocd-division/country:us/state:nc/county:robeson/precinct:03
ocd-division/country:us/state:nc/county:robeson/precinct:32a	ocd-division/country:us/state:nc/county:robeson/precinct:32
ocd-division/country:us/state:nc/county:robeson/precinct:4	ocd-division/country:us/state:nc/county:robeson/precinct:04
ocd-division/country:us/state:nc/county:robeson/precinct:5a	ocd-division/country:us/state:nc/county:robeson/precinct:05
ocd-division/country:us/state:nc/county:robeson/precinct:7	ocd-division/country:us/state:nc/county:robeson/precinct:07
ocd-division/country:us/state:nc/county:robeson/precinct:8	ocd-division/country:us/state:nc/county:robeson/precinct:08
ocd-division/country:us/state:nc/county:robeson/precinct:9	ocd-division/country:us/state:nc/county:robeson/precinct:09
ocd-division/country:us/state:nc/county:robeson/precinct:absentee	ocd-division/country:us/state:nc/county:robeson/precinct:absentee
ocd-division/country:us/state:nc/county:robeson/precinct:os_fairmont	ocd-division/country:us/state:nc/county:robeson/precinct:one_stop
ocd-division/country:us/state:nc/county:robeson/precinct:os_lumberton_boe	ocd-division/country:us/state:nc/county:robeson/precinct:one_stop
ocd-division/country:us/state:nc/county:robeson/precinct:os_maxton	ocd-division/country:us/state:nc/county:robeson/precinct:one_stop
ocd-division/country:us/state:nc/county:robeson/precinct:os_pembroke	ocd-division/country:us/state:nc/county:robeson/precinct:one_stop
ocd-division/country:us/state:nc/county:robeson/precinct:os_red_springs	ocd-division/country:us/state:nc/county:robeson/precinct:one_stop
ocd-division/country:us/state:nc/county:robeson/precinct:os_st_pauls	ocd-division/country:us/state:nc/county:robeson/precinct:one_stop
ocd-division/country:us/state:nc/county:gates/precinct:absentee	ocd-division/country:us/state:nc/county:gates/precinct:absentee
ocd-division/country:us/state:nc/county:gates/precinct:one_stop_1	ocd-division/country:us/state:nc/county:gates/precinct:one_stop
ocd-division/country:us/state:nc/county:gates/precinct:one_stop_2	ocd-division/country:us/state:nc/county:gates/precinct:one_stop
ocd-division/country:us/state:nc/county:perquimans/precinct:absentee	ocd-division/country:us/state:nc/county:perquimans/precinct:absentee
ocd-division/country:us/state:nc/county:perquimans/precinct:east_h	ocd-division/country:us/state:nc/county:perquimans/precinct:east-h
ocd-division/country:us/state:nc/county:perquimans/precinct:new_ho	ocd-division/country:us/state:nc/county:perquimans/precinct:new-ho
ocd-division/country:us/state:nc/county:perquimans/precinct:west_h	ocd-division/country:us/state:nc/county:perquimans/precinct:west-h
ocd-division/country:us/state:nc/county:rockingham/precinct:ms	ocd-division/country:us/state:nc/county:rockingham/precinct:md
ocd-division/country:us/state:nc/county:rockingham/precinct:se	ocd-division/country:us/state:nc/county:rockingham/precinct:ec
ocd-division/country:us/state:nc/county:rockingham/precinct:ws	ocd-division/country:us/state:nc/county:rockingham/precinct:wm
ocd-division/country:us/state:nc/county:henderson/precinct:absentee	ocd-division/country:us/state:nc/county:henderson/precinct:absentee
ocd-division/country:us/state:nc/county:henderson/precinct:cv	ocd-division/country:us/state:nc/county:henderson/precinct:cc
ocd-division/country:us/state:nc/county:anson/precinct:absentee	ocd-division/country:us/state:nc/county:anson/precinct:absentee
ocd-division/country:us/state:nc/county:anson/precinct:one_stop	ocd-division/country:us/state:nc/county:anson/precinct:one_stop
ocd-division/country:us/state:nc/county:halifax/precinct:absentee	ocd-division/country:us/state:nc/county:halifax/precinct:absentee
ocd-division/country:us/state:nc/county:halifax/precinct:enf1	ocd-division/country:us/state:nc/county:halifax/precinct:enf-1
ocd-division/country:us/state:nc/county:halifax/precinct:enf_2	ocd-division/country:us/state:nc/county:halifax/precinct:enf-2
ocd-division/country:us/state:nc/county:halifax/precinct:hpr	ocd-division/country:us/state:nc/county:halifax/precinct:provisional
ocd-division/country:us/state:nc/county:halifax/precinct:lit_1	ocd-division/country:us/state:nc/county:halifax/precinct:lit-1
ocd-division/country:us/state:nc/county:halifax/precinct:lit_2	ocd-division/country:us/state:nc/county:halifax/precinct:lit-2
ocd-division/country:us/state:nc/county:halifax/precinct:one-stop_halifax	ocd-division/country:us/state:nc/county:halifax/precinct:one_stop
ocd-division/country:us/state:nc/county:halifax/precinct:one-stop_roanoke_rapids	ocd-division/country:us/state:nc/county:halifax/precinct:one_stop
ocd-division/country:us/state:nc/county:halifax/precinct:one-stop_scotland_neck	ocd-division/country:us/state:nc/county:halifax/precinct:one_stop
ocd-division/country:us/state:nc/county:halifax/precinct:rr1-2	ocd-division/country:us/state:nc/county:halifax/precinct:rr-2
ocd-division/country:us/state:nc/county:halifax/precinct:rr_10	ocd-division/country:us/state:nc/county:halifax/precinct:rr-10
ocd-division/country:us/state:nc/county:halifax/precinct:rr_11	ocd-division/country:us/state:nc/county:halifax/precinct:rr-11
ocd-division/country:us/state:nc/county:halifax/precinct:rr_3	ocd-division/country:us/state:nc/county:halifax/precinct:rr-3
ocd-division/country:us/state:nc/county:halifax/precinct:rr_4	ocd-division/country:us/state:nc/county:halifax/precinct:rr-4
ocd-division/country:us/state:nc/county:halifax/precinct:rr_5	ocd-division/country:us/state:nc/county:halifax/precinct:rr-5
ocd-division/country:us/state:nc/county:halifax/precinct:rr_7	ocd-division/country:us/state:nc/county:halifax/precinct:rr-7
ocd-division/country:us/state:nc/county:halifax/precinct:rr_9	ocd-division/country:us/state:nc/county:halifax/precinct:rr-9
ocd-division/country:us/state:nc/county:halifax/precinct:rrc	ocd-division/country:us/state:nc/county:halifax/precinct:rr-8
ocd-division/country:us/state:nc/county:halifax/precinct:sn	ocd-division/country:us/state:nc/county:halifax/precinct:sn-1
ocd-division/country:us/state:nc/county:halifax/precinct:wel1-2	ocd-division/country:us/state:nc/county:halifax/precinct:wel-2
ocd-division/country:us/state:nc/county:halifax/precinct:wel_3	ocd-division/country:us/state:nc/county:halifax/precinct:wel-3
ocd-division/country:us/state:nc/county:mitchell/precinct:1	ocd-division/country:us/state:nc/county:mitchell/precinct:01
ocd-division/country:us/state:nc/county:mitchell/precinct:2	ocd-division/country:us/state:nc/county:mitchell/precinct:02
ocd-division/country:us/state:nc/county:mitchell/precinct:3	ocd-division/country:us/state:nc/county:mitchell/precinct:03
ocd-division/country:us/state:nc/county:mitchell/precinct:4	ocd-division/country:us/state:nc/county:mitchell/precinct:04
ocd-division/country:us/state:nc/county:mitchell/precinct:5	ocd-division/country:us/state:nc/county:mitchell/precinct:05
ocd-division/country:us/state:nc/county:mitchell/precinct:6	ocd-division/country:us/state:nc/county:mitchell/precinct:06
ocd-division/country:us/state:nc/county:mitchell/precinct:7	ocd-division/country:us/state:nc/county:mitchell/precinct:07
ocd-division/country:us/state:nc/county:mitchell/precinct:8	ocd-division/country:us/state:nc/county:mitchell/precinct:08
ocd-division/country:us/state:nc/county:mitchell/precinct:9	ocd-division/country:us/state:nc/county:mitchell/precinct:09
ocd-division/country:us/state:nc/county:bladen/precinct:mail_absentee	ocd-division/country:us/state:nc/county:bladen/precinct:absentee
ocd-division/country:us/state:nc/county:bladen/precinct:one_stop_b-boro	ocd-division/country:us/state:nc/county:bladen/precinct:one_stop
ocd-division/country:us/state:nc/county:bladen/precinct:one_stop_dublin	ocd-division/country:us/state:nc/county:bladen/precinct:one_stop
ocd-division/country:us/state:nc/county:bladen/precinct:one_stop_ea	ocd-division/country:us/state:nc/county:bladen/precinct:one_stop
ocd-division/country:us/state:nc/county:bladen/precinct:one_stop_library	ocd-division/country:us/state:nc/county:bladen/precinct:one_stop
ocd-division/country:us/state:nc/county:wilkes/precinct:absentee	ocd-division/country:us/state:nc/county:wilkes/precinct:absentee
ocd-division/country:us/state:nc/county:wilkes/precinct:os_miller_crk	ocd-division/country:us/state:nc/county:wilkes/precinct:one_stop
ocd-division/country:us/state:nc/county:wilkes/precinct:os_mtn_view	ocd-division/country:us/state:nc/county:wilkes/precinct:one_stop
ocd-division/country:us/state:nc/county:wilkes/precinct:os_mulberry	ocd-division/country:us/state:nc/county:wilkes/precinct:one_stop
ocd-division/country:us/state:nc/county:wilkes/precinct:os_office	ocd-division/country:us/state:nc/county:wilkes/precinct:one_stop
ocd-division/country:us/state:nc/county:wilkes/precinct:os_pleasant_hill	ocd-division/country:us/state:nc/county:wilkes/precinct:one_stop
ocd-division/country:us/state:nc/county:lenoir/precinct:absentee	ocd-division/country:us/state:nc/county:lenoir/precinct:absentee
ocd-division/country:us/state:nc/county:richmond/precinct:1	ocd-division/country:us/state:nc/county:richmond/precinct:01
ocd-division/country:us/state:nc/county:richmond/precinct:2	ocd-division/country:us/state:nc/county:richmond/precinct:02
ocd-division/country:us/state:nc/county:richmond/precinct:3	ocd-division/country:us/state:nc/county:richmond/precinct:03
ocd-division/country:us/state:nc/county:richmond/precinct:4	ocd-division/country:us/state:nc/county:richmond/precinct:04
ocd-division/country:us/state:nc/county:richmond/precinct:5	ocd-division/country:us/state:nc/county:richmond/precinct:05
ocd-division/country:us/state:nc/county:richmond/precinct:6	ocd-division/country:us/state:nc/county:richmond/precinct:06
ocd-division/country:us/state:nc/county:richmond/precinct:7	ocd-division/country:us/state:nc/county:richmond/precinct:07
ocd-division/country:us/state:nc/county:richmond/precinct:8	ocd-division/country:us/state:nc/county:richmond/precinct:08
ocd-division/country:us/state:nc/county:richmond/precinct:9	ocd-division/country:us/state:nc/county:richmond/precinct:09
ocd-division/country:us/state:nc/county:richmond/precinct:absentee	ocd-division/country:us/state:nc/county:richmond/precinct:absentee
ocd-division/country:us/state:nc/county:richmond/precinct:one_stop_100_cole	ocd-division/country:us/state:nc/county:richmond/precinct:one_stop
ocd-division/country:us/state:nc/county:richmond/precinct:one_stop_100_coop	ocd-division/country:us/state:nc/county:richmond/precinct:one_stop
ocd-division/country:us/state:nc/county:richmond/precinct:one_stop_100_ellerbe	ocd-division/country:us/state:nc/county:richmond/precinct:one_stop
ocd-division/country:us/state:nc/county:richmond/precinct:one_stop_100_norman	ocd-division/country:us/state:nc/county:richmond/precinct:one_stop
ocd-division/country:us/state:nc/county:watauga/precinct:1	ocd-division/country:us/state:nc/county:watauga/precinct:01
ocd-division/country:us/state:nc/county:watauga/precinct:2	ocd-division/country:us/state:nc/county:watauga/precinct:02
ocd-division/country:us/state:nc/county:watauga/precinct:3	ocd-division/country:us/state:nc/county:watauga/precinct:03
ocd-division/country:us/state:nc/county:watauga/precinct:4	ocd-division/country:us/state:nc/county:watauga/precinct:04
ocd-division/country:us/state:nc/county:watauga/precinct:5	ocd-division/country:us/state:nc/county:watauga/precinct:05
ocd-division/country:us/state:nc/county:watauga/precinct:6	ocd-division/country:us/state:nc/county:watauga/precinct:06
ocd-division/country:us/state:nc/county:watauga/precinct:7	ocd-division/country:us/state:nc/county:watauga/precinct:07
ocd-division/country:us/state:nc/county:watauga/precinct:8	ocd-division/country:us/state:nc/county:watauga/precinct:08
ocd-division/country:us/state:nc/county:watauga/precinct:9	ocd-division/country:us/state:nc/county:watauga/precinct:09
ocd-division/country:us/state:nc/county:watauga/precinct:absentee_mail	ocd-division/country:us/state:nc/county:watauga/precinct:absentee
ocd-division/country:us/state:nc/county:watauga/precinct:os_admin	ocd-division/country:us/state:nc/county:watauga/precinct:one_stop
ocd-division/country:us/state:nc/county:watauga/precinct:os_asu	ocd-division/country:us/state:nc/county:watauga/precinct:one_stop
ocd-division/country:us/state:nc/county:watauga/precinct:os_blowing_rock	ocd-division/country:us/state:nc/county:watauga/precinct:one_stop
ocd-division/country:us/state:nc/county:watauga/precinct:os_deep_gap	ocd-division/country:us/state:nc/county:watauga/precinct:one_stop
ocd-division/country:us/state:nc/county:watauga/precinct:os_meat_camp	ocd-division/country:us/state:nc/county:watauga/precinct:one_stop
ocd-division/country:us/state:nc/county:watauga/precinct:os_western_w	ocd-division/country:us/state:nc/county:watauga/precinct:one_stop
ocd-division/country:us/state:nc/county:johnston/precinct:one_stop_archer_lodge	ocd-division/country:us/state:nc/county:johnston/precinct:one_stop
ocd-division/country:us/state:nc/county:johnston/precinct:one_stop_benson	ocd-division/country:us/state:nc/county:johnston/precinct:one_stop
ocd-division/country:us/state:nc/county:johnston/precinct:one_stop_clayton	ocd-division/country:us/state:nc/county:johnston/precinct:one_stop
ocd-division/country:us/state:nc/county:johnston/precinct:one_stop_cleveland	ocd-division/country:us/state:nc/county:johnston/precinct:one_stop
ocd-division/country:us/state:nc/county:johnston/precinct:one_stop_smithfield	ocd-division/country:us/state:nc/county:johnston/precinct:one_stop
ocd-division/country:us/state:nc/county:johnston/precinct:pr10a	ocd-division/country:us/state:nc/county:johnston/precinct:pr10
ocd-division/country:us/state:nc/county:johnston/precinct:pr10b	ocd-division/country:us/state:nc/county:johnston/precinct:pr10
ocd-division/country:us/state:nc/county:johnston/precinct:pr12a	ocd-division/country:us/state:nc/county:johnston/precinct:pr12
ocd-division/country:us/state:nc/county:johnston/precinct:pr12b	ocd-division/country:us/state:nc/county:johnston/precinct:pr12
ocd-division/country:us/state:nc/county:johnston/precinct:pr23a	ocd-division/country:us/state:nc/county:johnston/precinct:pr23
ocd-division/country:us/state:nc/county:johnston/precinct:pr23b	ocd-division/country:us/state:nc/county:johnston/precinct:pr23
ocd-division/country:us/state:nc/county:johnston/precinct:pr27a	ocd-division/country:us/state:nc/county:johnston/precinct:pr27
ocd-division/country:us/state:nc/county:johnston/precinct:pr27b	ocd-division/country:us/state:nc/county:johnston/precinct:pr27
ocd-division/country:us/state:nc/county:johnston/precinct:pr35	ocd-division/country:us/state:nc/county:johnston/precinct:pr34
ocd-division/country:us/state:nc/county:johnston/precinct:pr36	ocd-division/country:us/state:nc/county:johnston/precinct:pr34
ocd-division/country:us/state:nc/county:johnston/precinct:pr37	ocd-division/country:us/state:nc/county:johnston/precinct:pr34
ocd-division/country:us/state:nc/county:johnston/precinct:pr38	ocd-division/country:us/state:nc/county:johnston/precinct:pr34
ocd-division/country:us/state:nc/county:mecklenburg/precinct:1	ocd-division/country:us/state:nc/county:mecklenburg/precinct:001
ocd-division/country:us/state:nc/county:mecklenburg/precinct:10	ocd-division/country:us/state:nc/county:mecklenburg/precinct:010
ocd-division/country:us/state:nc/county:mecklenburg/precinct:11	ocd-division/country:us/state:nc/county:mecklenburg/precinct:011
ocd-division/country:us/state:nc/county:mecklenburg/precinct:12	ocd-division/country:us/state:nc/county:mecklenburg/precinct:012
ocd-division/country:us/state:nc/county:mecklenburg/precinct:13	ocd-division/country:us/state:nc/county:mecklenburg/precinct:013
ocd-division/country:us/state:nc/county:mecklenburg/precinct:14	ocd-division/country:us/state:nc/county:mecklenburg/precinct:014
ocd-division/country:us/state:nc/county:mecklenburg/precinct:15	ocd-division/country:us/state:nc/county:mecklenburg/precinct:015
ocd-division/country:us/state:nc/county:mecklenburg/precinct:16	ocd-division/country:us/state:nc/county:mecklenburg/precinct:016
ocd-division/country:us/state:nc/county:mecklenburg/precinct:17	ocd-division/country:us/state:nc/county:mecklenburg/precinct:017
ocd-division/country:us/state:nc/county:mecklenburg/precinct:18	ocd-division/country:us/state:nc/county:mecklenburg/precinct:018
ocd-division/country:us/state:nc/county:mecklenburg/precinct:19	ocd-division/country:us/state:nc/county:mecklenburg/precinct:019
ocd-division/country:us/state:nc/county:mecklenburg/precinct:2	ocd-division/country:us/state:nc/county:mecklenburg/precinct:002
ocd-division/country:us/state:nc/county:mecklenburg/precinct:20	ocd-division/country:us/state:nc/county:mecklenburg/precinct:020
ocd-division/country:us/state:nc/county:mecklenburg/precinct:21	ocd-division/country:us/state:nc/county:mecklenburg/precinct:021
ocd-division/country:us/state:nc/county:mecklenburg/precinct:22	ocd-division/country:us/state:nc/county:mecklenburg/precinct:022
ocd-division/country:us/state:nc/county:mecklenburg/precinct:23	ocd-division/country:us/state:nc/county:mecklenburg/precinct:023
ocd-division/country:us/state:nc/county:mecklenburg/precinct:24	ocd-division/country:us/state:nc/county:mecklenburg/precinct:024
ocd-division/country:us/state:nc/county:mecklenburg/precinct:25	ocd-division/country:us/state:nc/county:mecklenburg/precinct:025
ocd-division/country:us/state:nc/county:mecklenburg/precinct:26	ocd-division/country:us/state:nc/county:mecklenburg/precinct:026
ocd-division/country:us/state:nc/county:mecklenburg/precinct:27	ocd-division/country:us/state:nc/county:mecklenburg/precinct:027
ocd-division/country:us/state:nc/county:mecklenburg/precinct:28	ocd-division/country:us/state:nc/county:mecklenburg/precinct:028
ocd-division/country:us/state:nc/county:mecklenburg/precinct:29	ocd-division/country:us/state:nc/county:mecklenburg/precinct:029
ocd-division/country:us/state:nc/county:mecklenburg/precinct:3	ocd-division/country:us/state:nc/county:mecklenburg/precinct:003
ocd-division/country:us/state:nc/county:mecklenburg/precinct:30	ocd-division/country:us/state:nc/county:mecklenburg/precinct:030
ocd-division/country:us/state:nc/county:mecklenburg/precinct:31	ocd-division/country:us/state:nc/county:mecklenburg/precinct:031
ocd-division/country:us/state:nc/county:mecklenburg/precinct:32	ocd-division/country:us/state:nc/county:mecklenburg/precinct:032
ocd-division/country:us/state:nc/county:mecklenburg/precinct:33	ocd-division/country:us/state:nc/county:mecklenburg/precinct:033
ocd-division/country:us/state:nc/county:mecklenburg/precinct:34	ocd-division/country:us/state:nc/county:mecklenburg/precinct:034
ocd-division/country:us/state:nc/county:mecklenburg/precinct:35	ocd-division/country:us/state:nc/county:mecklenburg/precinct:035
ocd-division/country:us/state:nc/county:mecklenburg/precinct:36	ocd-division/country:us/state:nc/county:mecklenburg/precinct:036
ocd-division/country:us/state:nc/county:mecklenburg/precinct:37	ocd-division/country:us/state:nc/county:mecklenburg/precinct:037
ocd-division/country:us/state:nc/county:mecklenburg/precinct:38	ocd-division/country:us/state:nc/county:mecklenburg/precinct:038
ocd-division/country:us/state:nc/county:mecklenburg/precinct:39	ocd-division/country:us/state:nc/county:mecklenburg/precinct:039
ocd-division/country:us/state:nc/county:mecklenburg/precinct:4	ocd-division/country:us/state:nc/county:mecklenburg/precinct:004
ocd-division/country:us/state:nc/county:mecklenburg/precinct:40	ocd-division/country:us/state:nc/county:mecklenburg/precinct:040
ocd-division/country:us/state:nc/county:mecklenburg/precinct:41	ocd-division/country:us/state:nc/county:mecklenburg/precinct:041
ocd-division/country:us/state:nc/county:mecklenburg/precinct:42	ocd-division/country:us/state:nc/county:mecklenburg/precinct:042
ocd-division/country:us/state:nc/county:mecklenburg/precinct:43	ocd-division/country:us/state:nc/county:mecklenburg/precinct:043
ocd-division/country:us/state:nc/county:mecklenburg/precinct:44	ocd-division/country:us/state:nc/county:mecklenburg/precinct:044
ocd-division/country:us/state:nc/county:mecklenburg/precinct:45	ocd-division/country:us/state:nc/county:mecklenburg/precinct:045
ocd-division/country:us/state:nc/county:mecklenburg/precinct:46	ocd-division/country:us/state:nc/county:mecklenburg/precinct:046
ocd-division/country:us/state:nc/county:mecklenburg/precinct:47	ocd-division/country:us/state:nc/county:mecklenburg/precinct:047
ocd-division/country:us/state:nc/county:mecklenburg/precinct:48	ocd-division/country:us/state:nc/county:mecklenburg/precinct:048
ocd-division/country:us/state:nc/county:mecklenburg/precinct:49	ocd-division/country:us/state:nc/county:mecklenburg/precinct:049
ocd-division/country:us/state:nc/county:mecklenburg/precinct:5	ocd-division/country:us/state:nc/county:mecklenburg/precinct:005
ocd-division/country:us/state:nc/county:mecklenburg/precinct:50	ocd-division/country:us/state:nc/county:mecklenburg/precinct:050
ocd-division/country:us/state:nc/county:mecklenburg/precinct:51	ocd-division/country:us/state:nc/county:mecklenburg/precinct:051
ocd-division/country:us/state:nc/county:mecklenburg/precinct:52	ocd-division/country:us/state:nc/county:mecklenburg/precinct:052
ocd-division/country:us/state:nc/county:mecklenburg/precinct:53	ocd-division/country:us/state:nc/county:mecklenburg/precinct:053
ocd-division/country:us/state:nc/county:mecklenburg/precinct:54	ocd-division/country:us/state:nc/county:mecklenburg/precinct:054
ocd-division/country:us/state:nc/county:mecklenburg/precinct:55	ocd-division/country:us/state:nc/county:mecklenburg/precinct:055
ocd-division/country:us/state:nc/county:mecklenburg/precinct:56	ocd-division/country:us/state:nc/county:mecklenburg/precinct:056
ocd-division/country:us/state:nc/county:mecklenburg/precinct:57	ocd-division/country:us/state:nc/county:mecklenburg/precinct:057
ocd-division/country:us/state:nc/county:mecklenburg/precinct:58	ocd-division/country:us/state:nc/county:mecklenburg/precinct:058
ocd-division/country:us/state:nc/county:mecklenburg/precinct:59	ocd-division/country:us/state:nc/county:mecklenburg/precinct:059
ocd-division/country:us/state:nc/county:mecklenburg/precinct:6	ocd-division/country:us/state:nc/county:mecklenburg/precinct:006
ocd-division/country:us/state:nc/county:mecklenburg/precinct:60	ocd-division/country:us/state:nc/county:mecklenburg/precinct:060
ocd-division/country:us/state:nc/county:mecklenburg/precinct:61	ocd-division/country:us/state:nc/county:mecklenburg/precinct:061
ocd-division/country:us/state:nc/county:mecklenburg/precinct:62	ocd-division/country:us/state:nc/county:mecklenburg/precinct:062
ocd-division/country:us/state:nc/county:mecklenburg/precinct:63	ocd-division/country:us/state:nc/county:mecklenburg/precinct:063
ocd-division/country:us/state:nc/county:mecklenburg/precinct:64	ocd-division/country:us/state:nc/county:mecklenburg/precinct:064
ocd-division/country:us/state:nc/county:mecklenburg/precinct:65	ocd-division/country:us/state:nc/county:mecklenburg/precinct:065
ocd-division/country:us/state:nc/county:mecklenburg/precinct:66	ocd-division/country:us/state:nc/county:mecklenburg/precinct:066
ocd-division/country:us/state:nc/county:mecklenburg/precinct:67	ocd-division/country:us/state:nc/county:mecklenburg/precinct:067
ocd-division/country:us/state:nc/county:mecklenburg/precinct:68	ocd-division/country:us/state:nc/county:mecklenburg/precinct:068
ocd-division/country:us/state:nc/county:mecklenburg/precinct:69	ocd-division/country:us/state:nc/county:mecklenburg/precinct:069
ocd-division/country:us/state:nc/county:mecklenburg/precinct:7	ocd-division/country:us/state:nc/county:mecklenburg/precinct:007
ocd-division/country:us/state:nc/county:mecklenburg/precinct:70	ocd-division/country:us/state:nc/county:mecklenburg/precinct:070
ocd-division/country:us/state:nc/county:mecklenburg/precinct:71	ocd-division/country:us/state:nc/county:mecklenburg/precinct:071
ocd-division/country:us/state:nc/county:mecklenburg/precinct:72	ocd-division/country:us/state:nc/county:mecklenburg/precinct:072
ocd-division/country:us/state:nc/county:mecklenburg/precinct:73	ocd-division/country:us/state:nc/county:mecklenburg/precinct:073
ocd-division/country:us/state:nc/county:mecklenburg/precinct:74	ocd-division/country:us/state:nc/county:mecklenburg/precinct:074
ocd-division/country:us/state:nc/county:mecklenburg/precinct:75	ocd-division/country:us/state:nc/county:mecklenburg/precinct:075
ocd-division/country:us/state:nc/county:mecklenburg/precinct:76	ocd-division/country:us/state:nc/county:mecklenburg/precinct:076
ocd-division/country:us/state:nc/county:mecklenburg/precinct:77	ocd-division/country:us/state:nc/county:mecklenburg/precinct:077
ocd-division/country:us/state:nc/county:mecklenburg/precinct:78.1	ocd-division/country:us/state:nc/county:mecklenburg/precinct:078.1
ocd-division/country:us/state:nc/county:mecklenburg/precinct:79	ocd-division/country:us/state:nc/county:mecklenburg/precinct:079
ocd-division/country:us/state:nc/county:mecklenburg/precinct:8	ocd-division/country:us/state:nc/county:mecklenburg/precinct:008
ocd-division/country:us/state:nc/county:mecklenburg/precinct:80	ocd-division/country:us/state:nc/county:mecklenburg/precinct:080
ocd-division/country:us/state:nc/county:mecklenburg/precinct:81	ocd-division/country:us/state:nc/county:mecklenburg/precinct:081
ocd-division/country:us/state:nc/county:mecklenburg/precinct:82	ocd-division/country:us/state:nc/county:mecklenburg/precinct:082
ocd-division/country:us/state:nc/county:mecklenburg/precinct:83	ocd-division/country:us/state:nc/county:mecklenburg/precinct:083
ocd-division/country:us/state:nc/county:mecklenburg/precinct:84	ocd-division/country:us/state:nc/county:mecklenburg/precinct:084
ocd-division/country:us/state:nc/county:mecklenburg/precinct:85	ocd-division/country:us/state:nc/county:mecklenburg/precinct:085
ocd-division/country:us/state:nc/county:mecklenburg/precinct:86	ocd-division/country:us/state:nc/county:mecklenburg/precinct:086
ocd-division/country:us/state:nc/county:mecklenburg/precinct:87	ocd-division/country:us/state:nc/county:mecklenburg/precinct:087
ocd-division/country:us/state:nc/county:mecklenburg/precinct:88	ocd-division/country:us/state:nc/county:mecklenburg/precinct:088
ocd-division/country:us/state:nc/county:mecklenburg/precinct:89	ocd-division/country:us/state:nc/county:mecklenburg/precinct:089
ocd-division/country:us/state:nc/county:mecklenburg/precinct:9	ocd-division/country:us/state:nc/county:mecklenburg/precinct:009
ocd-division/country:us/state:nc/county:mecklenburg/precinct:90	ocd-division/country:us/state:nc/county:mecklenburg/precinct:090
ocd-division/country:us/state:nc/county:mecklenburg/precinct:91	ocd-division/country:us/state:nc/county:mecklenburg/precinct:091
ocd-division/country:us/state:nc/county:mecklenburg/precinct:92	ocd-division/country:us/state:nc/county:mecklenburg/precinct:092
ocd-division/country:us/state:nc/county:mecklenburg/precinct:93	ocd-division/country:us/state:nc/county:mecklenburg/precinct:093
ocd-division/country:us/state:nc/county:mecklenburg/precinct:94	ocd-division/country:us/state:nc/county:mecklenburg/precinct:094
ocd-division/country:us/state:nc/county:mecklenburg/precinct:95	ocd-division/country:us/state:nc/county:mecklenburg/precinct:095
ocd-division/country:us/state:nc/county:mecklenburg/precinct:96	ocd-division/country:us/state:nc/county:mecklenburg/precinct:096
ocd-division/country:us/state:nc/county:mecklenburg/precinct:97	ocd-division/country:us/state:nc/county:mecklenburg/precinct:097
ocd-division/country:us/state:nc/county:mecklenburg/precinct:98	ocd-division/country:us/state:nc/county:mecklenburg/precinct:098
ocd-division/country:us/state:nc/county:mecklenburg/precinct:99	ocd-division/country:us/state:nc/county:mecklenburg/precinct:099
ocd-division/country:us/state:nc/county:mecklenburg/precinct:absentee_by_mail_1-20	ocd-division/country:us/state:nc/county:mecklenburg/precinct:absentee
ocd-division/country:us/state:nc/county:mecklenburg/precinct:absentee_by_mail_21-40	ocd-division/country:us/state:nc/county:mecklenburg/precinct:absentee
ocd-division/country:us/state:nc/county:mecklenburg/precinct:absentee_by_mail_41-60	ocd-division/country:us/state:nc/county:mecklenburg/precinct:absentee
ocd-division/country:us/state:nc/county:mecklenburg/precinct:absentee_by_mail_61-80	ocd-division/country:us/state:nc/county:mecklenburg/precinct:absentee
ocd-division/country:us/state:nc/county:mecklenburg/precinct:absentee_by_mail_81-96	ocd-division/country:us/state:nc/county:mecklenburg/precinct:absentee
ocd-division/country:us/state:nc/county:mecklenburg/precinct:curbside_1-20	ocd-division/country:us/state:nc/county:mecklenburg/precinct:provisional
ocd-division/country:us/state:nc/county:mecklenburg/precinct:curbside_21-40	ocd-division/country:us/state:nc/county:mecklenburg/precinct:provisional
ocd-division/country:us/state:nc/county:mecklenburg/precinct:curbside_41-60	ocd-division/country:us/state:nc/county:mecklenburg/precinct:provisional
ocd-division/country:us/state:nc/county:mecklenburg/precinct:curbside_61-80	ocd-division/country:us/state:nc/county:mecklenburg/precinct:provisional
ocd-division/country:us/state:nc/county:mecklenburg/precinct:curbside_81-96	ocd-division/country:us/state:nc/county:mecklenburg/precinct:provisional
ocd-division/country:us/state:nc/county:mecklenburg/precinct:provisional_1-20	ocd-division/country:us/state:nc/county:mecklenburg/precinct:provisional
ocd-division/country:us/state:nc/county:mecklenburg/precinct:provisional_21-40	ocd-division/country:us/state:nc/county:mecklenburg/precinct:provisional
ocd-division/country:us/state:nc/county:mecklenburg/precinct:provisional_41-60	ocd-division/country:us/state:nc/county:mecklenburg/precinct:provisional
ocd-division/country:us/state:nc/county:mecklenburg/precinct:provisional_61-80	ocd-division/country:us/state:nc/county:mecklenburg/precinct:provisional
ocd-division/country:us/state:nc/county:mecklenburg/precinct:provisional_81-96	ocd-division/country:us/state:nc/county:mecklenburg/precinct:provisional
ocd-division/country:us/state:nc/county:vance/precinct:cc	ocd-division/country:us/state:nc/county:vance/precinct:dabn
ocd-division/country:us/state:nc/county:vance/precinct:nh	ocd-division/country:us/state:nc/county:vance/precinct:nh2
ocd-division/country:us/state:nc/county:vance/precinct:nv	ocd-division/country:us/state:nc/county:vance/precinct:eh2
ocd-division/country:us/state:nc/county:vance/precinct:wh	ocd-division/country:us/state:nc/county:vance/precinct:wh1
ocd-division/country:us/state:nc/county:jackson/precinct:absentee	ocd-division/country:us/state:nc/county:jackson/precinct:absentee
ocd-division/country:us/state:nc/county:jackson/precinct:curbside_ed	ocd-division/country:us/state:nc/county:jackson/precinct:absentee
ocd-division/country:us/state:nc/county:jackson/precinct:curbside_os	ocd-division/country:us/state:nc/county:jackson/precinct:one_stop
ocd-division/country:us/state:nc/county:jackson/precinct:glv	ocd-division/country:us/state:nc/county:vance/precinct:wmsb
ocd-division/country:us/state:nc/county:jackson/precinct:scc	ocd-division/country:us/state:nc/county:jackson/precinct:allsc
ocd-division/country:us/state:nc/county:jackson/precinct:snd	ocd-division/country:us/state:nc/county:jackson/precinct:hammnt
ocd-division/country:us/state:nc/county:jackson/precinct:ssw	ocd-division/country:us/state:nc/county:jackson/precinct:syldil
ocd-division/country:us/state:nc/county:scotland/precinct:absentee	ocd-division/country:us/state:nc/county:scotland/precinct:absentee
ocd-division/country:us/state:nc/county:scotland/precinct:one_stop	ocd-division/country:us/state:nc/county:scotland/precinct:one_stop
ocd-division/country:us/state:nc/county:randolph/precinct:ae	ocd-division/country:us/state:nc/county:randolph/precinct:03
ocd-division/country:us/state:nc/county:randolph/precinct:an	ocd-division/country:us/state:nc/county:randolph/precinct:05
ocd-division/country:us/state:nc/county:randolph/precinct:ar	ocd-division/country:us/state:nc/county:randolph/precinct:01
ocd-division/country:us/state:nc/county:randolph/precinct:as	ocd-division/country:us/state:nc/county:randolph/precinct:07
ocd-division/country:us/state:nc/county:randolph/precinct:aw	ocd-division/country:us/state:nc/county:randolph/precinct:09
ocd-division/country:us/state:nc/county:randolph/precinct:bc	ocd-division/country:us/state:nc/county:randolph/precinct:11
ocd-division/country:us/state:nc/county:randolph/precinct:dr	ocd-division/country:us/state:nc/county:randolph/precinct:13
ocd-division/country:us/state:nc/county:randolph/precinct:gr	ocd-division/country:us/state:nc/county:randolph/precinct:15
ocd-division/country:us/state:nc/county:randolph/precinct:lb	ocd-division/country:us/state:nc/county:randolph/precinct:19
ocd-division/country:us/state:nc/county:randolph/precinct:lc	ocd-division/country:us/state:nc/county:randolph/precinct:17
ocd-division/country:us/state:nc/county:randolph/precinct:nm	ocd-division/country:us/state:nc/county:randolph/precinct:21
ocd-division/country:us/state:nc/county:randolph/precinct:pr	ocd-division/country:us/state:nc/county:randolph/precinct:23
ocd-division/country:us/state:nc/county:randolph/precinct:rm	ocd-division/country:us/state:nc/county:randolph/precinct:25
ocd-division/country:us/state:nc/county:randolph/precinct:rn	ocd-division/country:us/state:nc/county:randolph/precinct:27
ocd-division/country:us/state:nc/county:randolph/precinct:se	ocd-division/country:us/state:nc/county:randolph/precinct:29
ocd-division/country:us/state:nc/county:randolph/precinct:so	ocd-division/country:us/state:nc/county:randolph/precinct:31
ocd-division/country:us/state:nc/county:randolph/precinct:st	ocd-division/country:us/state:nc/county:randolph/precinct:35
ocd-division/country:us/state:nc/county:randolph/precinct:sw	ocd-division/country:us/state:nc/county:randolph/precinct:33
ocd-division/country:us/state:nc/county:randolph/precinct:tb	ocd-division/country:us/state:nc/county:randolph/precinct:37
ocd-division/country:us/state:nc/county:randolph/precinct:tr	ocd-division/country:us/state:nc/county:randolph/precinct:28
ocd-division/country:us/state:nc/county:randolph/precinct:tt	ocd-division/country:us/state:nc/county:randolph/precinct:39
ocd-division/country:us/state:nc/county:randolph/precinct:ug	ocd-division/country:us/state:nc/county:randolph/precinct:40
ocd-division/country:us/state:nc/county:surry/precinct:1	ocd-division/country:us/state:nc/county:surry/precinct:01
ocd-division/country:us/state:nc/county:surry/precinct:2	ocd-division/country:us/state:nc/county:surry/precinct:02
ocd-division/country:us/state:nc/county:surry/precinct:3	ocd-division/country:us/state:nc/county:surry/precinct:03
ocd-division/country:us/state:nc/county:surry/precinct:4	ocd-division/country:us/state:nc/county:surry/precinct:04
ocd-division/country:us/state:nc/county:surry/precinct:5	ocd-division/country:us/state:nc/county:surry/precinct:05
ocd-division/country:us/state:nc/county:surry/precinct:6	ocd-division/country:us/state:nc/county:surry/precinct:06
ocd-division/country:us/state:nc/county:surry/precinct:7	ocd-division/country:us/state:nc/county:surry/precinct:07
ocd-division/country:us/state:nc/county:surry/precinct:8	ocd-division/country:us/state:nc/county:surry/precinct:08
ocd-division/country:us/state:nc/county:surry/precinct:9	ocd-division/country:us/state:nc/county:surry/precinct:09
ocd-division/country:us/state:nc/county:surry/precinct:absentee	ocd-division/country:us/state:nc/county:surry/precinct:absentee
ocd-division/country:us/state:nc/county:cherokee/precinct:cson	ocd-division/country:us/state:nc/county:cherokee/precinct:beav
ocd-division/country:us/state:nc/county:cherokee/precinct:gcrk	ocd-division/country:us/state:nc/county:cherokee/precinct:beav
ocd-division/country:us/state:nc/county:cherokee/precinct:rger	ocd-division/country:us/state:nc/county:cherokee/precinct:notl
ocd-division/country:us/state:nc/county:cherokee/precinct:unka	ocd-division/country:us/state:nc/county:cherokee/precinct:notl
ocd-division/country:us/state:nc/county:person/precinct:pnth	ocd-division/country:us/state:nc/county:person/precinct:bfrk
ocd-division/country:us/state:nc/county:person/precinct:rctl	ocd-division/country:us/state:nc/county:person/precinct:rx1a
ocd-division/country:us/state:nc/county:person/precinct:swst	ocd-division/country:us/state:nc/county:person/precinct:huml
ocd-division/country:us/state:nc/county:wake/precinct:1-01	ocd-division/country:us/state:nc/county:wake/precinct:01-01
ocd-division/country:us/state:nc/county:wake/precinct:1-02	ocd-division/country:us/state:nc/county:wake/precinct:01-02
ocd-division/country:us/state:nc/county:wake/precinct:1-03	ocd-division/country:us/state:nc/county:wake/precinct:01-03
ocd-division/country:us/state:nc/county:wake/precinct:1-04	ocd-division/country:us/state:nc/county:wake/precinct:01-04
ocd-division/country:us/state:nc/county:wake/precinct:1-05	ocd-division/country:us/state:nc/county:wake/precinct:01-05
ocd-division/country:us/state:nc/county:wake/precinct:1-06	ocd-division/country:us/state:nc/county:wake/precinct:01-06
ocd-division/country:us/state:nc/county:wake/precinct:1-07	ocd-division/country:us/state:nc/county:wake/precinct:01-07
ocd-division/country:us/state:nc/county:wake/precinct:1-07a	ocd-division/country:us/state:nc/county:wake/precinct:01-07
ocd-division/country:us/state:nc/county:wake/precinct:1-09	ocd-division/country:us/state:nc/county:wake/precinct:01-09
ocd-division/country:us/state:nc/county:wake/precinct:1-10	ocd-division/country:us/state:nc/county:wake/precinct:01-10
ocd-division/country:us/state:nc/county:wake/precinct:1-11	ocd-division/country:us/state:nc/county:wake/precinct:01-11
ocd-division/country:us/state:nc/county:wake/precinct:1-12	ocd-division/country:us/state:nc/county:wake/precinct:01-12
ocd-division/country:us/state:nc/county:wake/precinct:1-13	ocd-division/country:us/state:nc/county:wake/precinct:01-13
ocd-division/country:us/state:nc/county:wake/precinct:1-14	ocd-division/country:us/state:nc/county:wake/precinct:01-14
ocd-division/country:us/state:nc/county:wake/precinct:1-15	ocd-division/country:us/state:nc/county:wake/precinct:01-15
ocd-division/country:us/state:nc/county:wake/precinct:1-16	ocd-division/country:us/state:nc/county:wake/precinct:01-16
ocd-division/country:us/state:nc/county:wake/precinct:1-17	ocd-division/country:us/state:nc/county:wake/precinct:01-17
ocd-division/country:us/state:nc/county:wake/precinct:1-18	ocd-division/country:us/state:nc/county:wake/precinct:01-18
ocd-division/country:us/state:nc/county:wake/precinct:1-19	ocd-division/country:us/state:nc/county:wake/precinct:01-19
ocd-division/country:us/state:nc/county:wake/precinct:1-20	ocd-division/country:us/state:nc/county:wake/precinct:01-20
ocd-division/country:us/state:nc/county:wake/precinct:1-21	ocd-division/country:us/state:nc/county:wake/precinct:01-21
ocd-division/country:us/state:nc/county:wake/precinct:1-22	ocd-division/country:us/state:nc/county:wake/precinct:01-22
ocd-division/country:us/state:nc/county:wake/precinct:1-23	ocd-division/country:us/state:nc/county:wake/precinct:01-23
ocd-division/country:us/state:nc/county:wake/precinct:1-25	ocd-division/country:us/state:nc/county:wake/precinct:01-25
ocd-division/country:us/state:nc/county:wake/precinct:1-26	ocd-division/country:us/state:nc/county:wake/precinct:01-26
ocd-division/country:us/state:nc/county:wake/precinct:1-27	ocd-division/country:us/state:nc/county:wake/precinct:01-27
ocd-division/country:us/state:nc/county:wake/precinct:1-28	ocd-division/country:us/state:nc/county:wake/precinct:01-28
ocd-division/country:us/state:nc/county:wake/precinct:1-29	ocd-division/country:us/state:nc/county:wake/precinct:01-29
ocd-division/country:us/state:nc/county:wake/precinct:1-30	ocd-division/country:us/state:nc/county:wake/precinct:01-30
ocd-division/country:us/state:nc/county:wake/precinct:1-31	ocd-division/country:us/state:nc/county:wake/precinct:01-31
ocd-division/country:us/state:nc/county:wake/precinct:1-32	ocd-division/country:us/state:nc/county:wake/precinct:01-32
ocd-division/country:us/state:nc/county:wake/precinct:1-33	ocd-division/country:us/state:nc/county:wake/precinct:01-33
ocd-division/country:us/state:nc/county:wake/precinct:1-34	ocd-division/country:us/state:nc/county:wake/precinct:01-34
ocd-division/country:us/state:nc/county:wake/precinct:1-35	ocd-division/country:us/state:nc/county:wake/precinct:01-35
ocd-division/country:us/state:nc/county:wake/precinct:1-36	ocd-division/country:us/state:nc/county:wake/precinct:01-36
ocd-division/country:us/state:nc/county:wake/precinct:1-37	ocd-division/country:us/state:nc/county:wake/precinct:01-37
ocd-division/country:us/state:nc/county:wake/precinct:1-38	ocd-division/country:us/state:nc/county:wake/precinct:01-38
ocd-division/country:us/state:nc/county:wake/precinct:1-39	ocd-division/country:us/state:nc/county:wake/precinct:01-39
ocd-division/country:us/state:nc/county:wake/precinct:1-40	ocd-division/country:us/state:nc/county:wake/precinct:01-40
ocd-division/country:us/state:nc/county:wake/precinct:1-41	ocd-division/country:us/state:nc/county:wake/precinct:01-41
ocd-division/country:us/state:nc/county:wake/precinct:1-42	ocd-division/country:us/state:nc/county:wake/precinct:01-42
ocd-division/country:us/state:nc/county:wake/precinct:1-43	ocd-division/country:us/state:nc/county:wake/precinct:01-43
ocd-division/country:us/state:nc/county:wake/precinct:1-44	ocd-division/country:us/state:nc/county:wake/precinct:01-44
ocd-division/country:us/state:nc/county:wake/precinct:1-45	ocd-division/country:us/state:nc/county:wake/precinct:01-45
ocd-division/country:us/state:nc/county:wake/precinct:1-46	ocd-division/country:us/state:nc/county:wake/precinct:01-46
ocd-division/country:us/state:nc/county:wake/precinct:1-47	ocd-division/country:us/state:nc/county:wake/precinct:01-47
ocd-division/country:us/state:nc/county:wake/precinct:1-48	ocd-division/country:us/state:nc/county:wake/precinct:01-48
ocd-division/country:us/state:nc/county:wake/precinct:1-49	ocd-division/country:us/state:nc/county:wake/precinct:01-49
ocd-division/country:us/state:nc/county:wake/precinct:1-50	ocd-division/country:us/state:nc/county:wake/precinct:01-50
ocd-division/country:us/state:nc/county:wake/precinct:1-51	ocd-division/country:us/state:nc/county:wake/precinct:01-51
ocd-division/country:us/state:nc/county:wake/precinct:19-13	ocd-division/country:us/state:nc/county:wake/precinct:19-06
ocd-division/country:us/state:nc/county:wake/precinct:19-14	ocd-division/country:us/state:nc/county:wake/precinct:19-16
ocd-division/country:us/state:nc/county:wake/precinct:19-15	ocd-division/country:us/state:nc/county:wake/precinct:19-16
ocd-division/country:us/state:nc/county:wake/precinct:2-01	ocd-division/country:us/state:nc/county:wake/precinct:02-01
ocd-division/country:us/state:nc/county:wake/precinct:2-02	ocd-division/country:us/state:nc/county:wake/precinct:02-02
ocd-division/country:us/state:nc/county:wake/precinct:2-03	ocd-division/country:us/state:nc/county:wake/precinct:02-03
ocd-division/country:us/state:nc/county:wake/precinct:2-04	ocd-division/country:us/state:nc/county:wake/precinct:02-04
ocd-division/country:us/state:nc/county:wake/precinct:2-05	ocd-division/country:us/state:nc/county:wake/precinct:02-05
ocd-division/country:us/state:nc/county:wake/precinct:2-06	ocd-division/country:us/state:nc/county:wake/precinct:02-06
ocd-division/country:us/state:nc/county:wake/precinct:20-06a	ocd-division/country:us/state:nc/county:wake/precinct:20-06
ocd-division/country:us/state:nc/county:wake/precinct:20-06b	ocd-division/country:us/state:nc/county:wake/precinct:20-06
ocd-division/country:us/state:nc/county:wake/precinct:20-14	ocd-division/country:us/state:nc/county:wake/precinct:20-12
ocd-division/country:us/state:nc/county:wake/precinct:20-15	ocd-division/country:us/state:nc/county:wake/precinct:20-12
ocd-division/country:us/state:nc/county:wake/precinct:20-16	ocd-division/country:us/state:nc/county:wake/precinct:20-12
ocd-division/country:us/state:nc/county:wake/precinct:20-17	ocd-division/country:us/state:nc/county:wake/precinct:20-12
ocd-division/country:us/state:nc/county:wake/precinct:3-00	ocd-division/country:us/state:nc/county:wake/precinct:03-00
ocd-division/country:us/state:nc/county:wake/precinct:4-01	ocd-division/country:us/state:nc/county:wake/precinct:04-01
ocd-division/country:us/state:nc/county:wake/precinct:4-02	ocd-division/country:us/state:nc/county:wake/precinct:04-02
ocd-division/country:us/state:nc/county:wake/precinct:4-03	ocd-division/country:us/state:nc/county:wake/precinct:04-03
ocd-division/country:us/state:nc/county:wake/precinct:4-04	ocd-division/country:us/state:nc/county:wake/precinct:04-04
ocd-division/country:us/state:nc/county:wake/precinct:4-05	ocd-division/country:us/state:nc/county:wake/precinct:04-05
ocd-division/country:us/state:nc/county:wake/precinct:4-06	ocd-division/country:us/state:nc/county:wake/precinct:04-06
ocd-division/country:us/state:nc/county:wake/precinct:4-07	ocd-division/country:us/state:nc/county:wake/precinct:04-07
ocd-division/country:us/state:nc/county:wake/precinct:4-08	ocd-division/country:us/state:nc/county:wake/precinct:04-08
ocd-division/country:us/state:nc/county:wake/precinct:4-09	ocd-division/country:us/state:nc/county:wake/precinct:04-09
ocd-division/country:us/state:nc/county:wake/precinct:4-10	ocd-division/country:us/state:nc/county:wake/precinct:04-10
ocd-division/country:us/state:nc/county:wake/precinct:4-11	ocd-division/country:us/state:nc/county:wake/precinct:04-11
ocd-division/country:us/state:nc/county:wake/precinct:4-12	ocd-division/country:us/state:nc/county:wake/precinct:04-12
ocd-division/country:us/state:nc/county:wake/precinct:4-13	ocd-division/country:us/state:nc/county:wake/precinct:04-13
ocd-division/country:us/state:nc/county:wake/precinct:4-14	ocd-division/country:us/state:nc/county:wake/precinct:04-14
ocd-division/country:us/state:nc/county:wake/precinct:4-15	ocd-division/country:us/state:nc/county:wake/precinct:04-15
ocd-division/country:us/state:nc/county:wake/precinct:4-16	ocd-division/country:us/state:nc/county:wake/precinct:04-16
ocd-division/country:us/state:nc/county:wake/precinct:4-17	ocd-division/country:us/state:nc/county:wake/precinct:04-17
ocd-division/country:us/state:nc/county:wake/precinct:4-18	ocd-division/country:us/state:nc/county:wake/precinct:04-18
ocd-division/country:us/state:nc/county:wake/precinct:4-19	ocd-division/country:us/state:nc/county:wake/precinct:04-19
ocd-division/country:us/state:nc/county:wake/precinct:4-20	ocd-division/country:us/state:nc/county:wake/precinct:04-20
ocd-division/country:us/state:nc/county:wake/precinct:4-21	ocd-division/country:us/state:nc/county:wake/precinct:04-21
ocd-division/country:us/state:nc/county:wake/precinct:5-01	ocd-division/country:us/state:nc/county:wake/precinct:05-01
ocd-division/country:us/state:nc/county:wake/precinct:5-03	ocd-division/country:us/state:nc/county:wake/precinct:05-03
ocd-division/country:us/state:nc/county:wake/precinct:5-05	ocd-division/country:us/state:nc/county:wake/precinct:05-05
ocd-division/country:us/state:nc/county:wake/precinct:5-06	ocd-division/country:us/state:nc/county:wake/precinct:05-06
ocd-division/country:us/state:nc/county:wake/precinct:5-07	ocd-division/country:us/state:nc/county:wake/precinct:05-06
ocd-division/country:us/state:nc/county:wake/precinct:5-08	ocd-division/country:us/state:nc/county:wake/precinct:05-06
ocd-division/country:us/state:nc/county:wake/precinct:6-04	ocd-division/country:us/state:nc/county:wake/precinct:06-04
ocd-division/country:us/state:nc/county:wake/precinct:6-05	ocd-division/country:us/state:nc/county:wake/precinct:06-05
ocd-division/country:us/state:nc/county:wake/precinct:6-06	ocd-division/country:us/state:nc/county:wake/precinct:06-06
ocd-division/country:us/state:nc/county:wake/precinct:6-07	ocd-division/country:us/state:nc/county:wake/precinct:06-07
ocd-division/country:us/state:nc/county:wake/precinct:6-08	ocd-division/country:us/state:nc/county:wake/precinct:06-07
ocd-division/country:us/state:nc/county:wake/precinct:6-09	ocd-division/country:us/state:nc/county:wake/precinct:06-07
ocd-division/country:us/state:nc/county:wake/precinct:6-10	ocd-division/country:us/state:nc/county:wake/precinct:06-07
ocd-division/country:us/state:nc/county:wake/precinct:7-01	ocd-division/country:us/state:nc/county:wake/precinct:07-01
ocd-division/country:us/state:nc/county:wake/precinct:7-02	ocd-division/country:us/state:nc/county:wake/precinct:07-02
ocd-division/country:us/state:nc/county:wake/precinct:7-03	ocd-division/country:us/state:nc/county:wake/precinct:07-03
ocd-division/country:us/state:nc/county:wake/precinct:7-04	ocd-division/country:us/state:nc/county:wake/precinct:07-04
ocd-division/country:us/state:nc/county:wake/precinct:7-05	ocd-division/country:us/state:nc/county:wake/precinct:07-05
ocd-division/country:us/state:nc/county:wake/precinct:7-06	ocd-division/country:us/state:nc/county:wake/precinct:07-06
ocd-division/country:us/state:nc/county:wake/precinct:7-07	ocd-division/country:us/state:nc/county:wake/precinct:07-07
ocd-division/country:us/state:nc/county:wake/precinct:7-07a	ocd-division/country:us/state:nc/county:wake/precinct:07-07
ocd-division/country:us/state:nc/county:wake/precinct:7-09	ocd-division/country:us/state:nc/county:wake/precinct:07-09
ocd-division/country:us/state:nc/county:wake/precinct:7-10	ocd-division/country:us/state:nc/county:wake/precinct:07-10
ocd-division/country:us/state:nc/county:wake/precinct:7-11	ocd-division/country:us/state:nc/county:wake/precinct:07-11
ocd-division/country:us/state:nc/county:wake/precinct:7-12	ocd-division/country:us/state:nc/county:wake/precinct:07-12
ocd-division/country:us/state:nc/county:wake/precinct:7-13	ocd-division/country:us/state:nc/county:wake/precinct:07-13
ocd-division/country:us/state:nc/county:wake/precinct:8-02	ocd-division/country:us/state:nc/county:wake/precinct:08-02
ocd-division/country:us/state:nc/county:wake/precinct:8-03	ocd-division/country:us/state:nc/county:wake/precinct:08-03
ocd-division/country:us/state:nc/county:wake/precinct:8-04	ocd-division/country:us/state:nc/county:wake/precinct:08-04
ocd-division/country:us/state:nc/county:wake/precinct:8-05	ocd-division/country:us/state:nc/county:wake/precinct:08-05
ocd-division/country:us/state:nc/county:wake/precinct:8-06	ocd-division/country:us/state:nc/county:wake/precinct:08-06
ocd-division/country:us/state:nc/county:wake/precinct:8-07	ocd-division/country:us/state:nc/county:wake/precinct:08-07
ocd-division/country:us/state:nc/county:wake/precinct:8-08	ocd-division/country:us/state:nc/county:wake/precinct:08-08
ocd-division/country:us/state:nc/county:wake/precinct:8-09	ocd-division/country:us/state:nc/county:wake/precinct:08-09
ocd-division/country:us/state:nc/county:wake/precinct:8-10	ocd-division/country:us/state:nc/county:wake/precinct:08-10
ocd-division/country:us/state:nc/county:wake/precinct:8-11	ocd-division/country:us/state:nc/county:wake/precinct:08-11
ocd-division/country:us/state:nc/county:wake/precinct:9-01	ocd-division/country:us/state:nc/county:wake/precinct:09-01
ocd-division/country:us/state:nc/county:wake/precinct:9-02	ocd-division/country:us/state:nc/county:wake/precinct:09-02
ocd-division/country:us/state:nc/county:wake/precinct:9-03	ocd-division/country:us/state:nc/county:wake/precinct:09-03
ocd-division/country:us/state:nc/county:wake/precinct:absen_1-40	ocd-division/country:us/state:nc/county:wake/precinct:absentee
ocd-division/country:us/state:nc/county:wake/precinct:absen_41-80	ocd-division/country:us/state:nc/county:wake/precinct:absentee
ocd-division/country:us/state:nc/county:wake/precinct:absen_81-91	ocd-division/country:us/state:nc/county:wake/precinct:absentee
ocd-division/country:us/state:nc/county:wake/precinct:osab_1-40	ocd-division/country:us/state:nc/county:wake/precinct:one_stop
ocd-division/country:us/state:nc/county:wake/precinct:osab_41-80	ocd-division/country:us/state:nc/county:wake/precinct:one_stop
ocd-division/country:us/state:nc/county:wake/precinct:osab_81-91	ocd-division/country:us/state:nc/county:wake/precinct:one_stop
ocd-division/country:us/state:nc/county:wake/precinct:osap_1-40	ocd-division/country:us/state:nc/county:wake/precinct:one_stop
ocd-division/country:us/state:nc/county:wake/precinct:osap_41-80	ocd-division/country:us/state:nc/county:wake/precinct:one_stop
ocd-division/country:us/state:nc/county:wake/precinct:osap_81-91	ocd-division/country:us/state:nc/county:wake/precinct:one_stop
ocd-division/country:us/state:nc/county:wake/precinct:osav_1-40	ocd-division/country:us/state:nc/county:wake/precinct:one_stop
ocd-division/country:us/state:nc/county:wake/precinct:osav_41-80	ocd-division/country:us/state:nc/county:wake/precinct:one_stop
ocd-division/country:us/state:nc/county:wake/precinct:osav_81-91	ocd-division/country:us/state:nc/county:wake/precinct:one_stop
ocd-division/country:us/state:nc/county:wake/precinct:osca_1-40	ocd-division/country:us/state:nc/county:wake/precinct:one_stop
ocd-division/country:us/state:nc/county:wake/precinct:osca_41-80	ocd-division/country:us/state:nc/county:wake/precinct:one_stop
ocd-division/country:us/state:nc/county:wake/precinct:osca_81-91	ocd-division/country:us/state:nc/county:wake/precinct:one_stop
ocd-division/country:us/state:nc/county:wake/precinct:oscb_1-40	ocd-division/country:us/state:nc/county:wake/precinct:one_stop
ocd-division/country:us/state:nc/county:wake/precinct:oscb_41-80	ocd-division/country:us/state:nc/county:wake/precinct:one_stop
ocd-division/country:us/state:nc/county:wake/precinct:oscb_81-91	ocd-division/country:us/state:nc/county:wake/precinct:one_stop
ocd-division/country:us/state:nc/county:wake/precinct:osch_1-40	ocd-division/country:us/state:nc/county:wake/precinct:one_stop
ocd-division/country:us/state:nc/county:wake/precinct:osch_41-80	ocd-division/country:us/state:nc/county:wake/precinct:one_stop
ocd-division/country:us/state:nc/county:wake/precinct:osch_81-91	ocd-division/country:us/state:nc/county:wake/precinct:one_stop
ocd-division/country:us/state:nc/county:wake/precinct:osfb_1-40	ocd-division/country:us/state:nc/county:wake/precinct:one_stop
ocd-division/country:us/state:nc/county:wake/precinct:osfb_41-80	ocd-division/country:us/state:nc/county:wake/precinct:one_stop
ocd-division/country:us/state:nc/county:wake/precinct:osfb_81-91	ocd-division/country:us/state:nc/county:wake/precinct:one_stop
ocd-division/country:us/state:nc/county:wake/precinct:osfv_1-40	ocd-division/country:us/state:nc/county:wake/precinct:one_stop
ocd-division/country:us/state:nc/county:wake/precinct:osfv_41-80	ocd-division/country:us/state:nc/county:wake/precinct:one_stop
ocd-division/country:us/state:nc/county:wake/precinct:osfv_81-91	ocd-division/country:us/state:nc/county:wake/precinct:one_stop
ocd-division/country:us/state:nc/county:wake/precinct:osgr_1-40	ocd-division/country:us/state:nc/county:wake/precinct:one_stop
ocd-division/country:us/state:nc/county:wake/precinct:osgr_41-80	ocd-division/country:us/state:nc/county:wake/precinct:one_stop
ocd-division/country:us/state:nc/county:wake/precinct:osgr_81-91	ocd-division/country:us/state:nc/county:wake/precinct:one_stop
ocd-division/country:us/state:nc/county:wake/precinct:oshs_1-40	ocd-division/country:us/state:nc/county:wake/precinct:one_stop
ocd-division/country:us/state:nc/county:wake/precinct:oshs_41-80	ocd-division/country:us/state:nc/county:wake/precinct:one_stop
ocd-division/country:us/state:nc/county:wake/precinct:oshs_81-91	ocd-division/country:us/state:nc/county:wake/precinct:one_stop
ocd-division/country:us/state:nc/county:wake/precinct:oskd_1-40	ocd-division/country:us/state:nc/county:wake/precinct:one_stop
ocd-division/country:us/state:nc/county:wake/precinct:oskd_41-80	ocd-division/country:us/state:nc/county:wake/precinct:one_stop
ocd-division/country:us/state:nc/county:wake/precinct:oskd_81-91	ocd-division/country:us/state:nc/county:wake/precinct:one_stop
ocd-division/country:us/state:nc/county:wake/precinct:osll_1-40	ocd-division/country:us/state:nc/county:wake/precinct:one_stop
ocd-division/country:us/state:nc/county:wake/precinct:osll_41-80	ocd-division/country:us/state:nc/county:wake/precinct:one_stop
ocd-division/country:us/state:nc/county:wake/precinct:osll_81-91	ocd-division/country:us/state:nc/county:wake/precinct:one_stop
ocd-division/country:us/state:nc/county:wake/precinct:oslob_1-40	ocd-division/country:us/state:nc/county:wake/precinct:one_stop
ocd-division/country:us/state:nc/county:wake/precinct:oslob_41-80	ocd-division/country:us/state:nc/county:wake/precinct:one_stop
ocd-division/country:us/state:nc/county:wake/precinct:oslob_81-91	ocd-division/country:us/state:nc/county:wake/precinct:one_stop
ocd-division/country:us/state:nc/county:wake/precinct:osnb_1-40	ocd-division/country:us/state:nc/county:wake/precinct:one_stop
ocd-division/country:us/state:nc/county:wake/precinct:osnb_41-80	ocd-division/country:us/state:nc/county:wake/precinct:one_stop
ocd-division/country:us/state:nc/county:wake/precinct:osnb_81-91	ocd-division/country:us/state:nc/county:wake/precinct:one_stop
ocd-division/country:us/state:nc/county:wake/precinct:osnr_1-40	ocd-division/country:us/state:nc/county:wake/precinct:one_stop
ocd-division/country:us/state:nc/county:wake/precinct:osnr_41-80	ocd-division/country:us/state:nc/county:wake/precinct:one_stop
ocd-division/country:us/state:nc/county:wake/precinct:osnr_81-91	ocd-division/country:us/state:nc/county:wake/precinct:one_stop
ocd-division/country:us/state:nc/county:wake/precinct:osop_1-40	ocd-division/country:us/state:nc/county:wake/precinct:one_stop
ocd-division/country:us/state:nc/county:wake/precinct:osop_41-80	ocd-division/country:us/state:nc/county:wake/precinct:one_stop
ocd-division/country:us/state:nc/county:wake/precinct:osop_81-91	ocd-division/country:us/state:nc/county:wake/precinct:one_stop
ocd-division/country:us/state:nc/county:wake/precinct:ostc_1-40	ocd-division/country:us/state:nc/county:wake/precinct:one_stop
ocd-division/country:us/state:nc/county:wake/precinct:ostc_41-80	ocd-division/country:us/state:nc/county:wake/precinct:one_stop
ocd-division/country:us/state:nc/county:wake/precinct:ostc_81-91	ocd-division/country:us/state:nc/county:wake/precinct:one_stop
ocd-division/country:us/state:nc/county:wake/precinct:oswa_1-40	ocd-division/country:us/state:nc/county:wake/precinct:one_stop
ocd-division/country:us/state:nc/county:wake/precinct:oswa_41-80	ocd-division/country:us/state:nc/county:wake/precinct:one_stop
ocd-division/country:us/state:nc/county:wake/precinct:oswa_81-91	ocd-division/country:us/state:nc/county:wake/precinct:one_stop
ocd-division/country:us/state:nc/county:wake/precinct:oswd_1-40	ocd-division/country:us/state:nc/county:wake/precinct:one_stop
ocd-division/country:us/state:nc/county:wake/precinct:oswd_41-80	ocd-division/country:us/state:nc/county:wake/precinct:one_stop
ocd-division/country:us/state:nc/county:wake/precinct:oswd_81-91	ocd-division/country:us/state:nc/county:wake/precinct:one_stop
ocd-division/country:us/state:nc/county:wake/precinct:oszb_1-40	ocd-division/country:us/state:nc/county:wake/precinct:one_stop
ocd-division/country:us/state:nc/county:wake/precinct:oszb_41-80	ocd-division/country:us/state:nc/county:wake/precinct:one_stop
ocd-division/country:us/state:nc/county:wake/precinct:oszb_81-91	ocd-division/country:us/state:nc/county:wake/precinct:one_stop
ocd-division/country:us/state:nc/county:wake/precinct:provi_1-40	ocd-division/country:us/state:nc/county:wake/precinct:provisional
ocd-division/country:us/state:nc/county:wake/precinct:provi_41-80	ocd-division/country:us/state:nc/county:wake/precinct:provisional
ocd-division/country:us/state:nc/county:wake/precinct:provi_81-91	ocd-division/country:us/state:nc/county:wake/precinct:provisional
ocd-division/country:us/state:nc/county:wake/precinct:trans_1-40	ocd-division/country:us/state:nc/county:wake/precinct:provisional
ocd-division/country:us/state:nc/county:wake/precinct:trans_41-80	ocd-division/country:us/state:nc/county:wake/precinct:provisional
ocd-division/country:us/state:nc/county:wake/precinct:trans_81-91	ocd-division/country:us/state:nc/county:wake/precinct:provisional
ocd-division/country:us/state:nc/county:rutherford/precinct:3a	ocd-division/country:us/state:nc/county:rutherford/precinct:03a
ocd-division/country:us/state:nc/county:rutherford/precinct:4a	ocd-division/country:us/state:nc/county:rutherford/precinct:04a
ocd-division/country:us/state:nc/county:rutherford/precinct:5a	ocd-division/country:us/state:nc/county:rutherford/precinct:05a
ocd-division/country:us/state:nc/county:rutherford/precinct:6a	ocd-division/country:us/state:nc/county:rutherford/precinct:06a
ocd-division/country:us/state:nc/county:rutherford/precinct:9a	ocd-division/country:us/state:nc/county:rutherford/precinct:09a
ocd-division/country:us/state:nc/county:rutherford/precinct:absentee	ocd-division/country:us/state:nc/county:rutherford/precinct:absentee
ocd-division/country:us/state:nc/county:rutherford/precinct:os-annex_paper	ocd-division/country:us/state:nc/county:rutherford/precinct:one_stop
ocd-division/country:us/state:nc/county:rutherford/precinct:os-boe_paper	ocd-division/country:us/state:nc/county:rutherford/precinct:one_stop
ocd-division/country:us/state:nc/county:rutherford/precinct:os-ellenboro_paper	ocd-division/country:us/state:nc/county:rutherford/precinct:one_stop
ocd-division/country:us/state:nc/county:wilson/precinct:absentee	ocd-division/country:us/state:nc/county:wilson/precinct:absentee
ocd-division/country:us/state:nc/county:wilson/precinct:one_stop_boe_paper	ocd-division/country:us/state:nc/county:wilson/precinct:one_stop
ocd-division/country:us/state:nc/county:wilson/precinct:one_stop_hd_paper	ocd-division/country:us/state:nc/county:wilson/precinct:one_stop
ocd-division/country:us/state:nc/county:alexander/precinct:g1g2	ocd-division/country:us/state:nc/county:alexander/precinct:g1
ocd-division/country:us/state:nc/county:alexander/precinct:lrsl	ocd-division/country:us/state:nc/county:alexander/precinct:sl
ocd-division/country:us/state:nc/county:alexander/precinct:s1s2	ocd-division/country:us/state:nc/county:alexander/precinct:s1
ocd-division/country:us/state:nc/county:alexander/precinct:t1t4t5	ocd-division/country:us/state:nc/county:alexander/precinct:t1
ocd-division/country:us/state:nc/county:alexander/precinct:t2t3	ocd-division/country:us/state:nc/county:alexander/precinct:t2
ocd-division/country:us/state:nc/county:macon/precinct:1	ocd-division/country:us/state:nc/county:macon/precinct:01
ocd-division/country:us/state:nc/county:macon/precinct:2	ocd-division/country:us/state:nc/county:macon/precinct:02
ocd-division/country:us/state:nc/county:macon/precinct:3	ocd-division/country:us/state:nc/county:macon/precinct:03
ocd-division/country:us/state:nc/county:macon/precinct:4	ocd-division/country:us/state:nc/county:macon/precinct:04
ocd-division/country:us/state:nc/county:macon/precinct:5	ocd-division/country:us/state:nc/county:macon/precinct:05
ocd-division/country:us/state:nc/county:macon/precinct:6	ocd-division/country:us/state:nc/county:macon/precinct:06
ocd-division/country:us/state:nc/county:macon/precinct:7	ocd-division/country:us/state:nc/county:macon/precinct:07
ocd-division/country:us/state:nc/county:macon/precinct:8	ocd-division/country:us/state:nc/county:macon/precinct:08
ocd-division/country:us/state:nc/county:macon/precinct:9	ocd-division/country:us/state:nc/county:macon/precinct:09
ocd-division/country:us/state:nc/county:macon/precinct:absentee	ocd-division/country:us/state:nc/county:macon/precinct:absentee
ocd-division/country:us/state:nc/county:macon/precinct:osboe	ocd-division/country:us/state:nc/county:macon/precinct:one_stop
ocd-division/country:us/state:nc/county:macon/precinct:oshos	ocd-division/country:us/state:nc/county:macon/precinct:one_stop
ocd-division/country:us/state:nc/county:lincoln/precinct:absentee	ocd-division/country:us/state:nc/county:lincoln/precinct:absentee
ocd-division/country:us/state:nc/county:lincoln/precinct:hc33	ocd-division/country:us/state:nc/county:lincoln/precinct:hg17
ocd-division/country:us/state:nc/county:lincoln/precinct:lb34	ocd-division/country:us/state:nc/county:lincoln/precinct:ls15
ocd-division/country:us/state:nc/county:lincoln/precinct:nb35	ocd-division/country:us/state:nc/county:lincoln/precinct:nb09
ocd-division/country:us/state:nc/county:lincoln/precinct:os-east	ocd-division/country:us/state:nc/county:lincoln/precinct:one_stop
ocd-division/country:us/state:nc/county:lincoln/precinct:os-lincoln	ocd-division/country:us/state:nc/county:lincoln/precinct:one_stop
ocd-division/country:us/state:nc/county:lincoln/precinct:os-west	ocd-division/country:us/state:nc/county:lincoln/precinct:one_stop
ocd-division/country:us/state:nc/county:lincoln/precinct:st36	ocd-division/country:us/state:nc/county:lincoln/precinct:og10
ocd-division/country:us/state:nc/county:lincoln/precinct:ta37	ocd-division/country:us/state:nc/county:lincoln/precinct:te27
ocd-division/country:us/state:nc/county:harnett/precinct:absentee	ocd-division/country:us/state:nc/county:harnett/precinct:absentee
ocd-division/country:us/state:nc/county:harnett/precinct:os_anderson	ocd-division/country:us/state:nc/county:harnett/precinct:one_stop
ocd-division/country:us/state:nc/county:harnett/precinct:os_angier	ocd-division/country:us/state:nc/county:harnett/precinct:one_stop
ocd-division/country:us/state:nc/county:harnett/precinct:os_erwin	ocd-division/country:us/state:nc/county:harnett/precinct:one_stop
ocd-division/country:us/state:nc/county:harnett/precinct:os_lobby	ocd-division/country:us/state:nc/county:harnett/precinct:one_stop
ocd-division/country:us/state:nc/county:harnett/precinct:os_western	ocd-division/country:us/state:nc/county:harnett/precinct:one_stop
ocd-division/country:us/state:nc/county:harnett/precinct:pr31	ocd-division/country:us/state:nc/county:harnett/precinct:pr17
ocd-division/country:us/state:nc/county:harnett/precinct:pr32	ocd-division/country:us/state:nc/county:harnett/precinct:pr27
ocd-division/country:us/state:nc/county:hyde/precinct:absentee	ocd-division/country:us/state:nc/county:hyde/precinct:absentee
ocd-division/country:us/state:nc/county:hyde/precinct:os_boe	ocd-division/country:us/state:nc/county:hyde/precinct:one_stop
ocd-division/country:us/state:nc/county:hyde/precinct:os_ock	ocd-division/country:us/state:nc/county:hyde/precinct:one_stop
ocd-division/country:us/state:nc/county:rowan/precinct:1	ocd-division/country:us/state:nc/county:rowan/precinct:01
ocd-division/country:us/state:nc/county:rowan/precinct:14a	ocd-division/country:us/state:nc/county:rowan/precinct:14
ocd-division/country:us/state:nc/county:rowan/precinct:19a	ocd-division/country:us/state:nc/county:rowan/precinct:19
ocd-division/country:us/state:nc/county:rowan/precinct:2	ocd-division/country:us/state:nc/county:rowan/precinct:02
ocd-division/country:us/state:nc/county:rowan/precinct:3	ocd-division/country:us/state:nc/county:rowan/precinct:03
ocd-division/country:us/state:nc/county:rowan/precinct:4	ocd-division/country:us/state:nc/county:rowan/precinct:04
ocd-division/country:us/state:nc/county:rowan/precinct:5a	ocd-division/country:us/state:nc/county:rowan/precinct:05
ocd-division/country:us/state:nc/county:rowan/precinct:7	ocd-division/country:us/state:nc/county:rowan/precinct:07
ocd-division/country:us/state:nc/county:rowan/precinct:8	ocd-division/country:us/state:nc/county:rowan/precinct:08
ocd-division/country:us/state:nc/county:rowan/precinct:9	ocd-division/country:us/state:nc/county:rowan/precinct:09
ocd-division/country:us/state:nc/county:caswell/precinct:absentee	ocd-division/country:us/state:nc/county:caswell/precinct:absentee
ocd-division/country:us/state:nc/county:caswell/precinct:ph	ocd-division/country:us/state:nc/county:caswell/precinct:pros
ocd-division/country:us/state:nc/county:caswell/precinct:yanc	ocd-division/country:us/state:nc/county:caswell/precinct:yan2
ocd-division/country:us/state:nc/county:chatham/precinct:absentee	ocd-division/country:us/state:nc/county:chatham/precinct:absentee
ocd-division/country:us/state:nc/county:chatham/precinct:one_stop	ocd-division/country:us/state:nc/county:chatham/precinct:one_stop
ocd-division/country:us/state:nc/county:washington/precinct:absentee	ocd-division/country:us/state:nc/county:washington/precinct:absentee
ocd-division/country:us/state:nc/county:washington/precinct:one_stop	ocd-division/country:us/state:nc/county:washington/precinct:one_stop
ocd-division/country:us/state:nc/county:mcdowell/precinct:fort_1	ocd-division/country:us/state:nc/county:mcdowell/precinct:fort-1
ocd-division/country:us/state:nc/county:mcdowell/precinct:fort_2	ocd-division/country:us/state:nc/county:mcdowell/precinct:fort-2
ocd-division/country:us/state:nc/county:mcdowell/precinct:mar_1	ocd-division/country:us/state:nc/county:mcdowell/precinct:mar-1
ocd-division/country:us/state:nc/county:mcdowell/precinct:mar_2	ocd-division/country:us/state:nc/county:mcdowell/precinct:mar-2
ocd-division/country:us/state:nc/county:mcdowell/precinct:mar_3	ocd-division/country:us/state:nc/county:mcdowell/precinct:mar-3
ocd-division/country:us/state:nc/county:mcdowell/precinct:mar_4	ocd-division/country:us/state:nc/county:mcdowell/precinct:mar-4
ocd-division/country:us/state:nc/county:mcdowell/precinct:mar_5	ocd-division/country:us/state:nc/county:mcdowell/precinct:mar-5
ocd-division/country:us/state:nc/county:mcdowell/precinct:west_m	ocd-division/country:us/state:nc/county:mcdowell/precinct:west-m
ocd-division/country:us/state:nc/county:alleghany/precinct:1	ocd-division/country:us/state:nc/county:alleghany/precinct:01
ocd-division/country:us/state:nc/county:alleghany/precinct:3a	ocd-division/country:us/state:nc/county:alleghany/precinct:03
ocd-division/country:us/state:nc/county:alleghany/precinct:4	ocd-division/country:us/state:nc/county:alleghany/precinct:04
ocd-division/country:us/state:nc/county:alleghany/precinct:6a	ocd-division/country:us/state:nc/county:alleghany/precinct:06
ocd-division/country:us/state:nc/county:alleghany/precinct:absentee	ocd-division/country:us/state:nc/county:alleghany/precinct:absentee
ocd-division/country:us/state:nc/county:duplin/precinct:absentee	ocd-division/country:us/state:nc/county:duplin/precinct:absentee
ocd-division/country:us/state:nc/county:duplin/precinct:cyck	ocd-division/country:us/state:nc/county:duplin/precinct:cyrk
ocd-division/country:us/state:nc/county:duplin/precinct:one_stop	ocd-division/country:us/state:nc/county:duplin/precinct:one_stop
ocd-division/country:us/state:nc/county:hoke/precinct:1	ocd-division/country:us/state:nc/county:hoke/precinct:01
ocd-division/country:us/state:nc/county:hoke/precinct:14	ocd-division/country:us/state:nc/county:hoke/precinct:13
ocd-division/country:us/state:nc/county:hoke/precinct:15	ocd-division/country:us/state:nc/county:hoke/precinct:13
ocd-division/country:us/state:nc/county:hoke/precinct:2	ocd-division/country:us/state:nc/county:hoke/precinct:02
ocd-division/country:us/state:nc/county:hoke/precinct:3	ocd-division/country:us/state:nc/county:hoke/precinct:03
ocd-division/country:us/state:nc/county:hoke/precinct:4	ocd-division/country:us/state:nc/county:hoke/precinct:04
ocd-division/country:us/state:nc/county:hoke/precinct:5	ocd-division/country:us/state:nc/county:hoke/precinct:05
ocd-division/country:us/state:nc/county:hoke/precinct:6b	ocd-division/country:us/state:nc/county:hoke/precinct:06
ocd-division/country:us/state:nc/county:alamance/precinct:1	ocd-division/country:us/state:nc/county:alamance/precinct:01
ocd-division/country:us/state:nc/county:alamance/precinct:2	ocd-division/country:us/state:nc/county:alamance/precinct:02
ocd-division/country:us/state:nc/county:alamance/precinct:35	ocd-division/country:us/state:nc/county:alamance/precinct:035
ocd-division/country:us/state:nc/county:alamance/precinct:3c	ocd-division/country:us/state:nc/county:alamance/precinct:03c
ocd-division/country:us/state:nc/county:alamance/precinct:3n	ocd-division/country:us/state:nc/county:alamance/precinct:03n
ocd-division/country:us/state:nc/county:alamance/precinct:3n2	ocd-division/country:us/state:nc/county:alamance/precinct:03n
ocd-division/country:us/state:nc/county:alamance/precinct:3s	ocd-division/country:us/state:nc/county:alamance/precinct:03s
ocd-division/country:us/state:nc/county:alamance/precinct:3w	ocd-division/country:us/state:nc/county:alamance/precinct:03w
ocd-division/country:us/state:nc/county:alamance/precinct:4	ocd-division/country:us/state:nc/county:alamance/precinct:04
ocd-division/country:us/state:nc/county:alamance/precinct:5	ocd-division/country:us/state:nc/county:alamance/precinct:05
ocd-division/country:us/state:nc/county:alamance/precinct:63	ocd-division/country:us/state:nc/county:alamance/precinct:063
ocd-division/country:us/state:nc/county:alamance/precinct:64	ocd-division/country:us/state:nc/county:alamance/precinct:064
ocd-division/country:us/state:nc/county:alamance/precinct:6e	ocd-division/country:us/state:nc/county:alamance/precinct:06e
ocd-division/country:us/state:nc/county:alamance/precinct:6n	ocd-division/country:us/state:nc/county:alamance/precinct:06n
ocd-division/country:us/state:nc/county:alamance/precinct:6s	ocd-division/country:us/state:nc/county:alamance/precinct:06s
ocd-division/country:us/state:nc/county:alamance/precinct:6w	ocd-division/country:us/state:nc/county:alamance/precinct:06w
ocd-division/country:us/state:nc/county:alamance/precinct:7	ocd-division/country:us/state:nc/county:alamance/precinct:07
ocd-division/country:us/state:nc/county:alamance/precinct:8n	ocd-division/country:us/state:nc/county:alamance/precinct:08n
ocd-division/country:us/state:nc/county:alamance/precinct:8s	ocd-division/country:us/state:nc/county:alamance/precinct:08s
ocd-division/country:us/state:nc/county:alamance/precinct:9n	ocd-division/country:us/state:nc/county:alamance/precinct:09n
ocd-division/country:us/state:nc/county:alamance/precinct:9s	ocd-division/country:us/state:nc/county:alamance/precinct:09s
ocd-division/country:us/state:nc/county:chowan/precinct:absentee	ocd-division/country:us/state:nc/county:chowan/precinct:absentee
ocd-division/country:us/state:nc/county:chowan/precinct:os_boe	ocd-division/country:us/state:nc/county:chowan/precinct:one_stop
ocd-division/country:us/state:nc/county:chowan/precinct:os_ncc	ocd-division/country:us/state:nc/county:chowan/precinct:one_stop
ocd-division/country:us/state:nc/county:yancey/precinct:10_pen	ocd-division/country:us/state:nc/county:yancey/precinct:10-pen
ocd-division/country:us/state:nc/county:yancey/precinct:11_pri	ocd-division/country:us/state:nc/county:yancey/precinct:11-pri
ocd-division/country:us/state:nc/county:yancey/precinct:1_bur	ocd-division/country:us/state:nc/county:yancey/precinct:01-bur
ocd-division/country:us/state:nc/county:yancey/precinct:2_can	ocd-division/country:us/state:nc/county:yancey/precinct:02-can
ocd-division/country:us/state:nc/county:yancey/precinct:3_egy	ocd-division/country:us/state:nc/county:yancey/precinct:03-egy
ocd-division/country:us/state:nc/county:yancey/precinct:4_ram	ocd-division/country:us/state:nc/county:yancey/precinct:04-ram
ocd-division/country:us/state:nc/county:yancey/precinct:5_gre	ocd-division/country:us/state:nc/county:yancey/precinct:05-gre
ocd-division/country:us/state:nc/county:yancey/precinct:6_jac	ocd-division/country:us/state:nc/county:yancey/precinct:06-jac
ocd-division/country:us/state:nc/county:yancey/precinct:7_bru	ocd-division/country:us/state:nc/county:yancey/precinct:07-bru
ocd-division/country:us/state:nc/county:yancey/precinct:8_cra	ocd-division/country:us/state:nc/county:yancey/precinct:08-cra
ocd-division/country:us/state:nc/county:yancey/precinct:9_sou	ocd-division/country:us/state:nc/county:yancey/precinct:09-sou
ocd-division/country:us/state:nc/county:craven/precinct:2	ocd-division/country:us/state:nc/county:craven/precinct:03
ocd-division/country:us/state:nc/county:craven/precinct:3	ocd-division/country:us/state:nc/county:craven/precinct:03
ocd-division/country:us/state:nc/county:craven/precinct:4	ocd-division/country:us/state:nc/county:craven/precinct:04
ocd-division/country:us/state:nc/county:craven/precinct:5	ocd-division/country:us/state:nc/county:craven/precinct:05
ocd-division/country:us/state:nc/county:craven/precinct:6	ocd-division/country:us/state:nc/county:craven/precinct:06
ocd-division/country:us/state:nc/county:craven/precinct:7	ocd-division/country:us/state:nc/county:craven/precinct:07
ocd-division/country:us/state:nc/county:craven/precinct:8	ocd-division/country:us/state:nc/county:craven/precinct:08
ocd-division/country:us/state:nc/county:craven/precinct:9	ocd-division/country:us/state:nc/county:craven/precinct:09
ocd-division/country:us/state:nc/county:catawba/precinct:1	ocd-division/country:us/state:nc/county:catawba/precinct:01
ocd-division/country:us/state:nc/county:catawba/precinct:2	ocd-division/country:us/state:nc/county:catawba/precinct:02
ocd-division/country:us/state:nc/county:catawba/precinct:3	ocd-division/country:us/state:nc/county:catawba/precinct:03
ocd-division/country:us/state:nc/county:catawba/precinct:4	ocd-division/country:us/state:nc/county:catawba/precinct:04
ocd-division/country:us/state:nc/county:catawba/precinct:5	ocd-division/country:us/state:nc/county:catawba/precinct:05
ocd-division/country:us/state:nc/county:catawba/precinct:6	ocd-division/country:us/state:nc/county:catawba/precinct:06
ocd-division/country:us/state:nc/county:catawba/precinct:7	ocd-division/country:us/state:nc/county:catawba/precinct:07
ocd-division/country:us/state:nc/county:catawba/precinct:8	ocd-division/country:us/state:nc/county:catawba/precinct:08
ocd-division/country:us/state:nc/county:catawba/precinct:9	ocd-division/country:us/state:nc/county:catawba/precinct:09
ocd-division/country:us/state:nc/county:catawba/precinct:absentee	ocd-division/country:us/state:nc/county:catawba/precinct:absentee
ocd-division/country:us/state:nc/county:currituck/precinct:absentee	ocd-division/country:us/state:nc/county:currituck/precinct:absentee
ocd-division/country:us/state:nc/county:currituck/precinct:one_stop	ocd-division/country:us/state:nc/county:currituck/precinct:one_stop
ocd-division/country:us/state:nc/county:pamlico/precinct:1al_a	ocd-division/country:us/state:nc/county:pamlico/precinct:1al
ocd-division/country:us/state:nc/county:pamlico/precinct:1gb	ocd-division/country:us/state:nc/county:pamlico/precinct:1al
ocd-division/country:us/state:nc/county:pamlico/precinct:4msic	ocd-division/country:us/state:nc/county:pamlico/precinct:4vm
ocd-division/country:us/state:nc/county:pamlico/precinct:4vm_a	ocd-division/country:us/state:nc/county:pamlico/precinct:4vm
ocd-division/country:us/state:nc/county:pamlico/precinct:absentee	ocd-division/country:us/state:nc/county:pamlico/precinct:absentee
ocd-division/country:us/state:nc/county:caldwell/precinct:absentee	ocd-division/country:us/state:nc/county:caldwell/precinct:absentee
ocd-division/country:us/state:nc/county:caldwell/precinct:one_stop_granite_falls	ocd-division/country:us/state:nc/county:caldwell/precinct:one_stop
ocd-division/country:us/state:nc/county:caldwell/precinct:one_stop_lenoir	ocd-division/country:us/state:nc/county:caldwell/precinct:one_stop
ocd-division/country:us/state:nc/county:caldwell/precinct:pr30	ocd-division/country:us/state:nc/county:caldwell/precinct:pr12
ocd-division/country:us/state:nc/county:caldwell/precinct:pr31	ocd-division/country:us/state:nc/county:caldwell/precinct:pr15
ocd-division/country:us/state:nc/county:caldwell/precinct:pr32	ocd-division/country:us/state:nc/county:caldwell/precinct:pr19
ocd-division/country:us/state:nc/county:caldwell/precinct:pr33	ocd-division/country:us/state:nc/county:caldwell/precinct:pr23
ocd-division/country:us/state:nc/county:caldwell/precinct:pr34	ocd-division/country:us/state:nc/county:caldwell/precinct:pr27
ocd-division/country:us/state:nc/county:caldwell/precinct:pr35	ocd-division/country:us/state:nc/county:caldwell/precinct:pr28
ocd-division/country:us/state:nc/county:northampton/precinct:lake_g	ocd-division/country:us/state:nc/county:northampton/precinct:lake-g
ocd-division/country:us/state:nc/county:northampton/precinct:os_gaston	ocd-division/country:us/state:nc/county:northampton/precinct:one_stop
ocd-division/country:us/state:nc/county:northampton/precinct:os_lake_gaston	ocd-division/country:us/state:nc/county:northampton/precinct:one_stop
ocd-division/country:us/state:nc/county:northampton/precinct:os_office	ocd-division/country:us/state:nc/county:northampton/precinct:one_stop
ocd-division/country:us/state:nc/county:northampton/precinct:os_rich_square	ocd-division/country:us/state:nc/county:northampton/precinct:one_stop
ocd-division/country:us/state:nc/county:northampton/precinct:rich_s	ocd-division/country:us/state:nc/county:northampton/precinct:rich-s
ocd-division/country:us/state:nc/county:nash/precinct:absentee	ocd-division/country:us/state:nc/county:nash/precinct:absentee
ocd-division/country:us/state:nc/county:nash/precinct:mt_pleasant_os	ocd-division/country:us/state:nc/county:nash/precinct:one_stop
ocd-division/country:us/state:nc/county:nash/precinct:nashville_os	ocd-division/country:us/state:nc/county:nash/precinct:one_stop
ocd-division/country:us/state:nc/county:nash/precinct:p01a	ocd-division/country:us/state:nc/county:nash/precinct:0001
ocd-division/country:us/state:nc/county:nash/precinct:p02a	ocd-division/country:us/state:nc/county:nash/precinct:0002
ocd-division/country:us/state:nc/county:nash/precinct:p03a	ocd-division/country:us/state:nc/county:nash/precinct:0003
ocd-division/country:us/state:nc/county:nash/precinct:p04a	ocd-division/country:us/state:nc/county:nash/precinct:0004
ocd-division/country:us/state:nc/county:nash/precinct:p05a	ocd-division/country:us/state:nc/county:nash/precinct:0005
ocd-division/country:us/state:nc/county:nash/precinct:p06a	ocd-division/country:us/state:nc/county:nash/precinct:0006
ocd-division/country:us/state:nc/county:nash/precinct:p07a	ocd-division/country:us/state:nc/county:nash/precinct:0007
ocd-division/country:us/state:nc/county:nash/precinct:p08a	ocd-division/country:us/state:nc/county:nash/precinct:0008
ocd-division/country:us/state:nc/county:nash/precinct:p09a	ocd-division/country:us/state:nc/county:nash/precinct:0025
ocd-division/country:us/state:nc/county:nash/precinct:p10a	ocd-division/country:us/state:nc/county:nash/precinct:0026
ocd-division/country:us/state:nc/county:nash/precinct:p11a	ocd-division/country:us/state:nc/county:nash/precinct:0011
ocd-division/country:us/state:nc/county:nash/precinct:p12a	ocd-division/country:us/state:nc/county:nash/precinct:0012
ocd-division/country:us/state:nc/county:nash/precinct:p13a	ocd-division/country:us/state:nc/county:nash/precinct:0031
ocd-division/country:us/state:nc/county:nash/precinct:p14a	ocd-division/country:us/state:nc/county:nash/precinct:0032
ocd-division/country:us/state:nc/county:nash/precinct:p15a	ocd-division/country:us/state:nc/county:nash/precinct:0015
ocd-division/country:us/state:nc/county:nash/precinct:p16a	ocd-division/country:us/state:nc/county:nash/precinct:0033
ocd-division/country:us/state:nc/county:nash/precinct:p17a	ocd-division/country:us/state:nc/county:nash/precinct:0034
ocd-division/country:us/state:nc/county:nash/precinct:p18a	ocd-division/country:us/state:nc/county:nash/precinct:0035
ocd-division/country:us/state:nc/county:nash/precinct:p19a	ocd-division/country:us/state:nc/county:nash/precinct:0036
ocd-division/country:us/state:nc/county:nash/precinct:p20a	ocd-division/country:us/state:nc/county:nash/precinct:0037
ocd-division/country:us/state:nc/county:nash/precinct:p21a	ocd-division/country:us/state:nc/county:nash/precinct:0021
ocd-division/country:us/state:nc/county:nash/precinct:p22a	ocd-division/country:us/state:nc/county:nash/precinct:0022
ocd-division/country:us/state:nc/county:nash/precinct:p23a	ocd-division/country:us/state:nc/county:nash/precinct:0038
ocd-division/country:us/state:nc/county:nash/precinct:p24a	ocd-division/country:us/state:nc/county:nash/precinct:0039
ocd-division/country:us/state:nc/county:nash/precinct:rocky_mount_os	ocd-division/country:us/state:nc/county:nash/precinct:one_stop
ocd-division/country:us/state:nc/county:nash/precinct:spring_hope_os	ocd-division/country:us/state:nc/county:nash/precinct:one_stop
ocd-division/country:us/state:nc/county:brunswick/precinct:1	ocd-division/country:us/state:nc/county:brunswick/precinct:01
ocd-division/country:us/state:nc/county:brunswick/precinct:10a	ocd-division/country:us/state:nc/county:brunswick/precinct:10
ocd-division/country:us/state:nc/county:brunswick/precinct:10b	ocd-division/country:us/state:nc/county:brunswick/precinct:10
ocd-division/country:us/state:nc/county:brunswick/precinct:2	ocd-division/country:us/state:nc/county:brunswick/precinct:02
ocd-division/country:us/state:nc/county:brunswick/precinct:3	ocd-division/country:us/state:nc/county:brunswick/precinct:03
ocd-division/country:us/state:nc/county:brunswick/precinct:4a	ocd-division/country:us/state:nc/county:brunswick/precinct:04
ocd-division/country:us/state:nc/county:brunswick/precinct:4b1	ocd-division/country:us/state:nc/county:brunswick/precinct:04
ocd-division/country:us/state:nc/county:brunswick/precinct:4c1	ocd-division/country:us/state:nc/county:brunswick/precinct:04
ocd-division/country:us/state:nc/county:brunswick/precinct:5	ocd-division/country:us/state:nc/county:brunswick/precinct:05
ocd-division/country:us/state:nc/county:brunswick/precinct:6	ocd-division/country:us/state:nc/county:brunswick/precinct:06
ocd-division/country:us/state:nc/county:brunswick/precinct:7	ocd-division/country:us/state:nc/county:brunswick/precinct:07
ocd-division/country:us/state:nc/county:brunswick/precinct:8	ocd-division/country:us/state:nc/county:brunswick/precinct:08
ocd-division/country:us/state:nc/county:brunswick/precinct:9	ocd-division/country:us/state:nc/county:brunswick/precinct:09
ocd-division/country:us/state:nc/county:brunswick/precinct:absentee_mail	ocd-division/country:us/state:nc/county:brunswick/precinct:absentee